whats all there ?	SELECT DISTINCT job.job_id FROM job
show me all job that are available	SELECT DISTINCT job.job_id FROM job
all ?	SELECT DISTINCT job.job_id FROM job
all of it ?	SELECT DISTINCT job.job_id FROM job
all the jobs please ?	SELECT DISTINCT job.job_id FROM job
show me all job that are available	SELECT DISTINCT job.job_id FROM job
give me a list of all the jobs ?	SELECT DISTINCT job.job_id FROM job
show me what jobs there are ?	SELECT DISTINCT job.job_id FROM job
show me everything ?	SELECT DISTINCT job.job_id FROM job
everything ?	SELECT DISTINCT job.job_id FROM job
could you list all the jobs ?	SELECT DISTINCT job.job_id FROM job
what work do you have available ?	SELECT DISTINCT job.job_id FROM job
what are all the jobs ?	SELECT DISTINCT job.job_id FROM job
id like to see everything ?	SELECT DISTINCT job.job_id FROM job
what jobs are there ?	SELECT DISTINCT job.job_id FROM job
i would like to see all the jobs ?	SELECT DISTINCT job.job_id FROM job
show me what needs experience ?	SELECT DISTINCT job.job_id FROM job WHERE job.req_exp is not NULL
show me jobs requiring no experience	SELECT DISTINCT job.job_id FROM job WHERE job.req_exp is NULL
show me jobs requiring no experience	SELECT DISTINCT job.job_id FROM job WHERE job.req_exp is NULL
show jobs in usa ?	SELECT DISTINCT job.job_id FROM job JOIN country ON job.job_id = country.job_id WHERE country.country = "usa"
what jobs are there for a com specialist ?	SELECT DISTINCT job.job_id FROM job JOIN area ON job.job_id = area.job_id WHERE area.area = "com"
show the jobs for a com specialist ?	SELECT DISTINCT job.job_id FROM job JOIN area ON job.job_id = area.job_id WHERE area.area = "com"
list jobs in wan ?	SELECT DISTINCT job.job_id FROM job JOIN area ON job.job_id = area.job_id WHERE area.area = "wan"
what jobs are there for a gui specialist ?	SELECT DISTINCT job.job_id FROM job JOIN area ON job.job_id = area.job_id WHERE area.area = "gui"
show me positions in web programming ?	SELECT DISTINCT job.job_id FROM job JOIN area ON job.job_id = area.job_id WHERE area.area = "web"
are there any jobs in lan ?	SELECT DISTINCT job.job_id FROM job JOIN area ON job.job_id = area.job_id WHERE area.area = "lan"
give me the jobs for a lan specialist ?	SELECT DISTINCT job.job_id FROM job JOIN area ON job.job_id = area.job_id WHERE area.area = "lan"
show me the jobs that require 2 years experience	SELECT DISTINCT job.job_id FROM job WHERE job.req_exp = 2
what jobs need at least 2 years of experience ?	SELECT DISTINCT job.job_id FROM job WHERE job.req_exp = 2
show me jobs in texas	SELECT DISTINCT job.job_id FROM job JOIN city ON job.job_id = city.job_id WHERE city.city_name = "texas"
show me the jobs that require 2 years experience	SELECT DISTINCT job.job_id FROM job WHERE job.req_exp = 2
show the jobs for a odbc specialist ?	SELECT DISTINCT job.job_id FROM job JOIN area ON job.job_id = area.job_id WHERE area.area = "odbc"
are there any jobs requiring bs ?	SELECT DISTINCT job.job_id FROM job WHERE job.req_deg = "BS"
are there any jobs requiring ba ?	SELECT DISTINCT job.job_id FROM job WHERE job.req_deg = "BA"
give me the jobs in dallas ?	SELECT DISTINCT job.job_id FROM job JOIN city ON job.job_id = city.job_id WHERE city.city_name = "dallas"
give me the jobs for a games specialist ?	SELECT DISTINCT job.job_id FROM job JOIN area ON job.job_id = area.job_id WHERE area.area = "games"
what jobs are there in games ?	SELECT DISTINCT job.job_id FROM job JOIN area ON job.job_id = area.job_id WHERE area.area = "games"
give me jobs in dallas ?	SELECT DISTINCT job.job_id FROM job JOIN city ON job.job_id = city.job_id WHERE city.city_name = "dallas"
are there any jobs in austin ?	SELECT DISTINCT job.job_id FROM job JOIN city ON job.job_id = city.job_id WHERE city.city_name = "austin"
show the jobs in austin ?	SELECT DISTINCT job.job_id FROM job JOIN city ON job.job_id = city.job_id WHERE city.city_name = "austin"
list jobs in austin ?	SELECT DISTINCT job.job_id FROM job JOIN city ON job.job_id = city.job_id WHERE city.city_name = "austin"
show the jobs in dallas ?	SELECT DISTINCT job.job_id FROM job JOIN city ON job.job_id = city.job_id WHERE city.city_name = "dallas"
list the jobs requiring bs ?	SELECT DISTINCT job.job_id FROM job WHERE job.req_deg = "BS"
tell me the jobs requiring bs ?	SELECT DISTINCT job.job_id FROM job WHERE job.req_deg = "BS"
show jobs requiring ba ?	SELECT DISTINCT job.job_id FROM job WHERE job.req_deg = "BA"
list jobs in austin ?	SELECT DISTINCT job.job_id FROM job JOIN city ON job.job_id = city.job_id WHERE city.city_name = "austin"
list jobs requiring ba ?	SELECT DISTINCT job.job_id FROM job WHERE job.req_deg = "BA"
what jobs are there requiring ba ?	SELECT DISTINCT job.job_id FROM job WHERE job.req_deg = "BA"
give me jobs for a games specialist ?	SELECT DISTINCT job.job_id FROM job JOIN area ON job.job_id = area.job_id WHERE area.area = "games"
give me jobs requiring bs ?	SELECT DISTINCT job.job_id FROM job WHERE job.req_deg = "BS"
are there any jobs requiring bs ?	SELECT DISTINCT job.job_id FROM job WHERE job.req_deg = "BS"
what jobs are there requiring bs ?	SELECT DISTINCT job.job_id FROM job WHERE job.req_deg = "BS"
are there any jobs requiring ba ?	SELECT DISTINCT job.job_id FROM job WHERE job.req_deg = "BA"
show the jobs requiring ba ?	SELECT DISTINCT job.job_id FROM job WHERE job.req_deg = "BA"
give me jobs requiring bs ?	SELECT DISTINCT job.job_id FROM job WHERE job.req_deg = "BS"
what jobs are there in houston ?	SELECT DISTINCT job.job_id FROM job JOIN city ON job.job_id = city.job_id WHERE city.city_name = "houston"
are there any jobs in houston ?	SELECT DISTINCT job.job_id FROM job JOIN city ON job.job_id = city.job_id WHERE city.city_name = "houston"
what jobs are there in usa ?	SELECT DISTINCT job.job_id FROM job JOIN country ON job.job_id = country.job_id WHERE country.country = "usa"
tell me the jobs on mvs ?	SELECT DISTINCT job.job_id FROM job JOIN platform ON job.job_id = platform.job_id WHERE platform.platform = "mvs"
show me the jobs that operate on sun ?	SELECT DISTINCT job.job_id FROM job JOIN platform ON job.job_id = platform.job_id WHERE platform.platform = "sun"
what jobs are there requiring bscs ?	SELECT DISTINCT job.job_id FROM job WHERE job.req_deg = "BSCS"
list jobs on sun ?	SELECT DISTINCT job.job_id FROM job JOIN platform ON job.job_id = platform.job_id WHERE platform.platform = "sun"
list the jobs in 'c++' ?	SELECT DISTINCT job.job_id FROM job JOIN language ON job.job_id = language.job_id WHERE language.language = "c++"
are there any jobs requiring bsee ?	SELECT DISTINCT job.job_id FROM job WHERE job.req_deg = "BSEE"
are there any jobs requiring bsee ?	SELECT DISTINCT job.job_id FROM job WHERE job.req_deg = "BSEE"
list jobs requiring bsee ?	SELECT DISTINCT job.job_id FROM job WHERE job.req_deg = "BSEE"
show jobs requiring bsee ?	SELECT DISTINCT job.job_id FROM job WHERE job.req_deg = "BSEE"
are there any jobs on sun ?	SELECT DISTINCT job.job_id FROM job JOIN platform ON job.job_id = platform.job_id WHERE platform.platform = "sun"
are there any jobs using sql ?	SELECT DISTINCT job.job_id FROM job JOIN language ON job.job_id = language.job_id WHERE language.language = "sql"
are there any jobs on ibm ?	SELECT DISTINCT job.job_id FROM job JOIN platform ON job.job_id = platform.job_id WHERE platform.platform = "ibm"
are there any jobs requiring bscs ?	SELECT DISTINCT job.job_id FROM job WHERE job.req_deg = "BSCS"
what jobs are there on x86 ?	SELECT DISTINCT job.job_id FROM job JOIN platform ON job.job_id = platform.job_id WHERE platform.platform = "x86"
show the jobs on sun ?	SELECT DISTINCT job.job_id FROM job JOIN platform ON job.job_id = platform.job_id WHERE platform.platform = "sun"
are there any jobs on vax ?	SELECT DISTINCT job.job_id FROM job JOIN platform ON job.job_id = platform.job_id WHERE platform.platform = "vax"
what jobs are there requiring bsee ?	SELECT DISTINCT job.job_id FROM job WHERE job.req_deg = "BSEE"
what jobs are there using rpg ?	SELECT DISTINCT job.job_id FROM job JOIN language ON job.job_id = language.job_id WHERE language.language = "rpg"
give me the jobs requiring bsee ?	SELECT DISTINCT job.job_id FROM job WHERE job.req_deg = "BSEE"
what jobs are there on x86 ?	SELECT DISTINCT job.job_id FROM job JOIN platform ON job.job_id = platform.job_id WHERE platform.platform = "x86"
what jobs are there on aix ?	SELECT DISTINCT job.job_id FROM job JOIN platform ON job.job_id = platform.job_id WHERE platform.platform = "aix"
list jobs using sql ?	SELECT DISTINCT job.job_id FROM job JOIN language ON job.job_id = language.job_id WHERE language.language = "sql"
show the jobs requiring bsee ?	SELECT DISTINCT job.job_id FROM job WHERE job.req_deg = "BSEE"
show the jobs on mvs ?	SELECT DISTINCT job.job_id FROM job JOIN platform ON job.job_id = platform.job_id WHERE platform.platform = "mvs"
show the jobs on vms ?	SELECT DISTINCT job.job_id FROM job JOIN platform ON job.job_id = platform.job_id WHERE platform.platform = "vms"
i want a job that use 'c++' ?	SELECT DISTINCT job.job_id FROM job JOIN language ON job.job_id = language.job_id WHERE language.language = "c++"
what jobs require a bscs ?	SELECT DISTINCT job.job_id FROM job WHERE job.req_deg = "BSCS"
what jobs are there on vms ?	SELECT DISTINCT job.job_id FROM job JOIN platform ON job.job_id = platform.job_id WHERE platform.platform = "vms"
give me the jobs using sql ?	SELECT DISTINCT job.job_id FROM job JOIN language ON job.job_id = language.job_id WHERE language.language = "sql"
what jobs are there using sql ?	SELECT DISTINCT job.job_id FROM job JOIN language ON job.job_id = language.job_id WHERE language.language = "sql"
are there any jobs requiring bscs ?	SELECT DISTINCT job.job_id FROM job WHERE job.req_deg = "BSCS"
are there any mac jobs open ?	SELECT DISTINCT job.job_id FROM job JOIN platform ON job.job_id = platform.job_id WHERE platform.platform = "mac"
any jobs available using database ?	SELECT DISTINCT job.job_id FROM job JOIN area ON job.job_id = area.job_id WHERE area.area = "database"
show jobs using cics ?	SELECT DISTINCT job.job_id FROM job JOIN language ON job.job_id = language.job_id WHERE language.language = "cics"
what jobs does lcs recruit for ?	SELECT DISTINCT job.job_id FROM job WHERE job.recruiter = "LCS"
show jobs in html ?	SELECT DISTINCT job.job_id FROM job JOIN language ON job.job_id = language.job_id WHERE language.language = "html"
what database jobs are there ?	SELECT DISTINCT job.job_id FROM job JOIN area ON job.job_id = area.job_id WHERE area.area = "database"
give me the jobs on unix ?	SELECT DISTINCT job.job_id FROM job JOIN platform ON job.job_id = platform.job_id WHERE platform.platform = "unix"
are there any jobs for a graphics specialist ?	SELECT DISTINCT job.job_id FROM job JOIN area ON job.job_id = area.job_id WHERE area.area = "graphics"
what jobs are there using cics ?	SELECT DISTINCT job.job_id FROM job JOIN language ON job.job_id = language.job_id WHERE language.language = "cics"
are there any unix jobs ?	SELECT DISTINCT job.job_id FROM job JOIN platform ON job.job_id = platform.job_id WHERE platform.platform = "unix"
show the jobs using html ?	SELECT DISTINCT job.job_id FROM job JOIN language ON job.job_id = language.job_id WHERE language.language = "html"
i would like to find a job using java ?	SELECT DISTINCT job.job_id FROM job JOIN language ON job.job_id = language.job_id WHERE language.language = "java"
list the jobs on unix ?	SELECT DISTINCT job.job_id FROM job JOIN platform ON job.job_id = platform.job_id WHERE platform.platform = "unix"
what jobs are there for a database specialist ?	SELECT DISTINCT job.job_id FROM job JOIN area ON job.job_id = area.job_id WHERE area.area = "database"
any jobs available using database ?	SELECT DISTINCT job.job_id FROM job JOIN area ON job.job_id = area.job_id WHERE area.area = "database"
tell me jobs using html ?	SELECT DISTINCT job.job_id FROM job JOIN language ON job.job_id = language.job_id WHERE language.language = "html"
list the jobs in database ?	SELECT DISTINCT job.job_id FROM job JOIN area ON job.job_id = area.job_id WHERE area.area = "database"
list the jobs using cics ?	SELECT DISTINCT job.job_id FROM job JOIN language ON job.job_id = language.job_id WHERE language.language = "cics"
list the jobs for a database specialist ?	SELECT DISTINCT job.job_id FROM job JOIN area ON job.job_id = area.job_id WHERE area.area = "database"
are there any jobs that require the knowledge of linux platform ?	SELECT DISTINCT job.job_id FROM job JOIN platform ON job.job_id = platform.job_id WHERE platform.platform = "linux"
what jobs can i find with tivoli ?	SELECT DISTINCT job.job_id FROM job WHERE job.company = "Tivoli"
what jobs are there using cobol ?	SELECT DISTINCT job.job_id FROM job JOIN language ON job.job_id = language.job_id WHERE language.language = "cobol"
are there any jobs using cobol ?	SELECT DISTINCT job.job_id FROM job JOIN language ON job.job_id = language.job_id WHERE language.language = "cobol"
what positions are there in networking ?	SELECT DISTINCT job.job_id FROM job JOIN area ON job.job_id = area.job_id WHERE area.area = "networking"
what jobs are there for a networking specialist ?	SELECT DISTINCT job.job_id FROM job JOIN area ON job.job_id = area.job_id WHERE area.area = "networking"
tell me jobs in networking ?	SELECT DISTINCT job.job_id FROM job JOIN area ON job.job_id = area.job_id WHERE area.area = "networking"
what jobs are there using 'tcl/tk' ?	SELECT DISTINCT job.job_id FROM job JOIN language ON job.job_id = language.job_id WHERE language.language = "tcl/tk"
are there any computer jobs in the field of statistics ?	SELECT DISTINCT job.job_id FROM job JOIN area ON job.job_id = area.job_id WHERE area.area = "statistics"
are there any jobs on novell ?	SELECT DISTINCT job.job_id FROM job JOIN platform ON job.job_id = platform.job_id WHERE platform.platform = "novell"
are there any jobs for a programmer ?	SELECT DISTINCT job.job_id FROM job WHERE job.title = "Programmer"
are there any programmer jobs open ?	SELECT DISTINCT job.job_id FROM job WHERE job.title = "Programmer"
are there any programmer jobs open ?	SELECT DISTINCT job.job_id FROM job WHERE job.title = "Programmer"
is fortran required for any jobs ?	SELECT DISTINCT job.job_id FROM job JOIN language ON job.job_id = language.job_id WHERE language.language = "fortran"
are there any jobs on windows ?	SELECT DISTINCT job.job_id FROM job JOIN platform ON job.job_id = platform.job_id WHERE platform.platform = "windows"
show jobs on windows ?	SELECT DISTINCT job.job_id FROM job JOIN platform ON job.job_id = platform.job_id WHERE platform.platform = "windows"
give me jobs in san antonio ?	SELECT DISTINCT job.job_id FROM job JOIN city ON job.job_id = city.job_id WHERE city.city_name = "san antonio"
list jobs using assembly ?	SELECT DISTINCT job.job_id FROM job JOIN language ON job.job_id = language.job_id WHERE language.language = "assembly"
list the positions that require a knowledge of microsoft excel ?	SELECT DISTINCT job.job_id FROM job JOIN application ON job.job_id = application.job_id WHERE application.application = "excel"
list the positions that require a knowledge of microsoft excel ?	SELECT DISTINCT job.job_id FROM job JOIN application ON job.job_id = application.job_id WHERE application.application = "excel"
are there any jobs in san antonio ?	SELECT DISTINCT job.job_id FROM job JOIN city ON job.job_id = city.job_id WHERE city.city_name = "san antonio"
list the jobs using assembly ?	SELECT DISTINCT job.job_id FROM job JOIN language ON job.job_id = language.job_id WHERE language.language = "assembly"
show the jobs in san antonio ?	SELECT DISTINCT job.job_id FROM job JOIN city ON job.job_id = city.job_id WHERE city.city_name = "san antonio"
are there any jobs in san antonio ?	SELECT DISTINCT job.job_id FROM job JOIN city ON job.job_id = city.job_id WHERE city.city_name = "san antonio"
what jobs does microsoft recruit for ?	SELECT DISTINCT job.job_id FROM job WHERE job.company = "Microsoft"
show me jobs not involving 'c++' ?	SELECT DISTINCT job.job_id FROM job JOIN language ON job.job_id = language.job_id WHERE language.language != "c++"
show me jobs not involving 'c++' ?	SELECT DISTINCT job.job_id FROM job JOIN language ON job.job_id = language.job_id WHERE language.language != "c++"
what jobs have a salary greater than 20 and hour ?	SELECT DISTINCT job.job_id FROM job JOIN salary ON job.job_id = salary.job_id WHERE salary.money >= 20 AND salary.time = "hour"
tell me the jobs in '3d' graphics ?	SELECT DISTINCT job.job_id FROM job JOIN area ON job.job_id = area.job_id WHERE area.area = "3d graphics"
show me something that requires oracle ?	SELECT DISTINCT job.job_id FROM job JOIN application ON job.job_id = application.job_id WHERE application.application = "oracle"
what jobs are there for a '3d' graphics specialist ?	SELECT DISTINCT job.job_id FROM job JOIN area ON job.job_id = area.job_id WHERE area.area = "3d graphics"
are there any jobs for a client server specialist ?	SELECT DISTINCT job.job_id FROM job JOIN area ON job.job_id = area.job_id WHERE area.area = "client/server"
what jobs are there for a '3d' graphics specialist ?	SELECT DISTINCT job.job_id FROM job JOIN area ON job.job_id = area.job_id WHERE area.area = "3d graphics"
show the jobs in client server ?	SELECT DISTINCT job.job_id FROM job JOIN area ON job.job_id = area.job_id WHERE area.area = "client/server"
list the jobs for a client server specialist ?	SELECT DISTINCT job.job_id FROM job JOIN area ON job.job_id = area.job_id WHERE area.area = "client/server"
what jobs are longhorn employment hiring for ?	SELECT DISTINCT job.job_id FROM job WHERE job.recruiter = "Longhorn"
list jobs in client server ?	SELECT DISTINCT job.job_id FROM job JOIN area ON job.job_id = area.job_id WHERE area.area = "client/server"
what jobs are longhorn employment hiring for ?	SELECT DISTINCT job.job_id FROM job WHERE job.recruiter = "Longhorn"
are there any autocad jobs open ?	SELECT DISTINCT job.job_id FROM job JOIN application ON job.job_id = application.job_id WHERE application.application = "autocad"
list the jobs using cobol ii ?	SELECT DISTINCT job.job_id FROM job JOIN language ON job.job_id = language.job_id WHERE language.language = "cobol ii"
list jobs in cobol ii ?	SELECT DISTINCT job.job_id FROM job JOIN language ON job.job_id = language.job_id WHERE language.language = "cobol ii"
give me jobs in cobol ii ?	SELECT DISTINCT job.job_id FROM job JOIN language ON job.job_id = language.job_id WHERE language.language = "cobol ii"
are there any autocad jobs open ?	SELECT DISTINCT job.job_id FROM job JOIN application ON job.job_id = application.job_id WHERE application.application = "autocad"
tell me jobs using cobol ii ?	SELECT DISTINCT job.job_id FROM job JOIN language ON job.job_id = language.job_id WHERE language.language = "cobol ii"
tell me jobs for a device driver specialist ?	SELECT DISTINCT job.job_id FROM job JOIN area ON job.job_id = area.job_id WHERE area.area = "device driver"
what are the jobs that pay 50000 per year ?	SELECT DISTINCT job.job_id FROM job JOIN salary ON job.job_id = salary.job_id WHERE salary.money >= 50000 AND salary.time = "year"
what jobs are there with a salary of 40000 ?	SELECT DISTINCT job.job_id FROM job JOIN salary ON job.job_id = salary.job_id WHERE salary.money >= 40000 AND salary.time = "year"
what jobs are there with a salary of more than 50000 dollars per year ?	SELECT DISTINCT job.job_id FROM job JOIN salary ON job.job_id = salary.job_id WHERE salary.money >= 50000 AND salary.time = "year"
show me jobs with a salary greater than 50000 dollars a year ?	SELECT DISTINCT job.job_id FROM job JOIN salary ON job.job_id = salary.job_id WHERE salary.money >= 50000 AND salary.time = "year"
show me the jobs with 30000 salary	SELECT DISTINCT job.job_id FROM job JOIN salary ON job.job_id = salary.job_id WHERE salary.money >= 30000 AND salary.time = "year"
what jobs are there with a salary of 40000 ?	SELECT DISTINCT job.job_id FROM job JOIN salary ON job.job_id = salary.job_id WHERE salary.money >= 40000 AND salary.time = "year"
what jobs pay 40000 ?	SELECT DISTINCT job.job_id FROM job JOIN salary ON job.job_id = salary.job_id WHERE salary.money >= 40000 AND salary.time = "year"
show me the jobs with 30000 salary	SELECT DISTINCT job.job_id FROM job JOIN salary ON job.job_id = salary.job_id WHERE salary.money >= 30000 AND salary.time = "year"
show me jobs paying greater than 50000 per year ?	SELECT DISTINCT job.job_id FROM job JOIN salary ON job.job_id = salary.job_id WHERE salary.money >= 50000 AND salary.time = "year"
what jobs pay at least 80000 dollars per year ?	SELECT DISTINCT job.job_id FROM job JOIN salary ON job.job_id = salary.job_id WHERE salary.money >= 80000 AND salary.time = "year"
list the jobs in visual 'c++' ?	SELECT DISTINCT job.job_id FROM job JOIN language ON job.job_id = language.job_id WHERE language.language = "visual c++"
tell me the jobs using powerbuilder ?	SELECT DISTINCT job.job_id FROM job JOIN language ON job.job_id = language.job_id WHERE language.language = "powerbuilder"
give me jobs using visual 'c++' ?	SELECT DISTINCT job.job_id FROM job JOIN language ON job.job_id = language.job_id WHERE language.language = "visual c++"
which jobs use visual 'j++' as their development tool ?	SELECT DISTINCT job.job_id FROM job JOIN language ON job.job_id = language.job_id WHERE language.language = "visual j++"
which jobs use visual 'j++' as their development tool ?	SELECT DISTINCT job.job_id FROM job JOIN language ON job.job_id = language.job_id WHERE language.language = "visual j++"
what jobs are there on windows 95 ?	SELECT DISTINCT job.job_id FROM job JOIN platform ON job.job_id = platform.job_id WHERE platform.platform = "windows 95"
show the jobs in visual 'c++' ?	SELECT DISTINCT job.job_id FROM job JOIN language ON job.job_id = language.job_id WHERE language.language = "visual c++"
give me the jobs in visual 'c++' ?	SELECT DISTINCT job.job_id FROM job JOIN language ON job.job_id = language.job_id WHERE language.language = "visual c++"
are there any jobs using powerbuilder ?	SELECT DISTINCT job.job_id FROM job JOIN language ON job.job_id = language.job_id WHERE language.language = "powerbuilder"
tell me the jobs on windows nt ?	SELECT DISTINCT job.job_id FROM job JOIN platform ON job.job_id = platform.job_id WHERE platform.platform = "windows nt"
what jobs are there on windows nt ?	SELECT DISTINCT job.job_id FROM job JOIN platform ON job.job_id = platform.job_id WHERE platform.platform = "windows nt"
show jobs using powerbuilder ?	SELECT DISTINCT job.job_id FROM job JOIN language ON job.job_id = language.job_id WHERE language.language = "powerbuilder"
show me the jobs that are not in haskell ?	SELECT DISTINCT job.job_id FROM job JOIN language ON job.job_id = language.job_id WHERE language.language != "haskell"
i want a job that doesnt use windows ?	SELECT DISTINCT job.job_id FROM job JOIN platform ON job.job_id = platform.job_id WHERE platform.platform != "windows"
show me the jobs that are not in haskell ?	SELECT DISTINCT job.job_id FROM job JOIN language ON job.job_id = language.job_id WHERE language.language != "haskell"
are there any jobs with a salary of 100000 ?	SELECT DISTINCT job.job_id FROM job JOIN salary ON job.job_id = salary.job_id WHERE salary.money >= 100000 AND salary.time = "year"
what jobs have a recruiter named phil smith ?	SELECT DISTINCT job.job_id FROM job WHERE job.recruiter = "Phil Smith"
are there any jobs for a data warehousing specialist ?	SELECT DISTINCT job.job_id FROM job JOIN area ON job.job_id = area.job_id WHERE area.area = "data warehousing"
tell me the jobs using visual basic ?	SELECT DISTINCT job.job_id FROM job JOIN language ON job.job_id = language.job_id WHERE language.language = "visual basic"
what jobs are there in data warehousing ?	SELECT DISTINCT job.job_id FROM job JOIN area ON job.job_id = area.job_id WHERE area.area = "data warehousing"
are there any project manager positions open ?	SELECT DISTINCT job.job_id FROM job WHERE job.title = "Project Manager"
show jobs for a data warehousing specialist ?	SELECT DISTINCT job.job_id FROM job JOIN area ON job.job_id = area.job_id WHERE area.area = "data warehousing"
give me jobs for a data warehousing specialist ?	SELECT DISTINCT job.job_id FROM job JOIN area ON job.job_id = area.job_id WHERE area.area = "data warehousing"
tell me jobs using visual basic ?	SELECT DISTINCT job.job_id FROM job JOIN language ON job.job_id = language.job_id WHERE language.language = "visual basic"
show jobs using visual basic ?	SELECT DISTINCT job.job_id FROM job JOIN language ON job.job_id = language.job_id WHERE language.language = "visual basic"
are there any project manager positions open ?	SELECT DISTINCT job.job_id FROM job WHERE job.title = "Project Manager"
list the required experience for a job using lisp ?	SELECT DISTINCT job.req_exp FROM job JOIN language ON job.job_id = language.job_id WHERE language.language = "lisp"
show me the job application for ic design engineer ?	SELECT DISTINCT job.job_id FROM job WHERE job.title = "Ic Design Engineer"
what jobs desire a degree but dont use 'c++'	SELECT DISTINCT job.job_id FROM job JOIN language ON job.job_id = language.job_id WHERE language.language != "c++" AND job.des_deg is not NULL
what jobs desire a degree but dont use 'c++'	SELECT DISTINCT job.job_id FROM job JOIN language ON job.job_id = language.job_id WHERE language.language != "c++" AND job.des_deg is not NULL
how much experience is wanted for a job at microsoft ?	SELECT DISTINCT job.req_exp FROM job WHERE job.company = "Microsoft"
are there any jobs in the us with the title verification engineer ?	SELECT DISTINCT job.job_id FROM job WHERE job.title = "Verification Engineer"
what are the degree requirements for a software engineer ?	SELECT DISTINCT job.req_deg FROM job WHERE job.title = "Software Engineer"
list the companies that desire 'c++' experience ?	SELECT DISTINCT job.company FROM job JOIN language ON job.job_id = language.job_id WHERE language.language = "c++" AND job.des_exp is not NULL
what project manager jobs are there that require experience ?	SELECT DISTINCT job.job_id FROM job WHERE job.title = "Project Manager" AND job.req_exp is not NULL
what are the jobs that require experience with microsoft word ?	SELECT DISTINCT job.job_id FROM job JOIN application ON job.job_id = application.job_id WHERE application.application = "microsoft word" AND job.req_exp is not NULL
what are the jobs that require experience with microsoft word ?	SELECT DISTINCT job.job_id FROM job JOIN application ON job.job_id = application.job_id WHERE application.application = "microsoft word" AND job.req_exp is not NULL
show the jobs for bscs in austin ?	SELECT DISTINCT job.job_id FROM job JOIN city ON job.job_id = city.job_id WHERE job.req_deg = "BSCS" AND city.city_name = "austin"
tell me the jobs requiring bs in usa ?	SELECT DISTINCT job.job_id FROM job JOIN country ON job.job_id = country.job_id WHERE job.req_deg = "BS" AND country.country = "usa"
are there jobs that do not require a degree in houston ?	SELECT DISTINCT job.job_id FROM job JOIN city ON job.job_id = city.job_id WHERE city.city_name = "houston" AND job.req_deg is NULL
are there any jobs specializing in ai with jpl ?	SELECT DISTINCT job.job_id FROM job JOIN area ON job.job_id = area.job_id WHERE area.area = "ai" AND job.company = "JPL"
show me the jobs that require 1 year of experience but desire 2 years of experiences	SELECT DISTINCT job.job_id FROM job WHERE job.req_exp = 1 AND job.des_exp = 2
are there any jobs specializing in ai with jpl ?	SELECT DISTINCT job.job_id FROM job JOIN area ON job.job_id = area.job_id WHERE area.area = "ai" AND job.company = "JPL"
what jobs need knowledge of 'c++' or java ?	SELECT DISTINCT job.job_id FROM job JOIN language ON job.job_id = language.job_id WHERE language.language = "c++" OR language.language = "java"
what jobs are there in usa on ibm ?	SELECT DISTINCT job.job_id FROM job JOIN country ON job.job_id = country.job_id JOIN platform ON job.job_id = platform.job_id WHERE country.country = "usa" AND platform.platform = "ibm"
what ai positions require only a bscs ?	SELECT DISTINCT job.job_id FROM job JOIN area ON job.job_id = area.job_id WHERE area.area = "ai" AND job.req_deg = "BSCS"
what jobs are there in austin that require 5 years experience ?	SELECT DISTINCT job.job_id FROM job JOIN city ON job.job_id = city.job_id WHERE city.city_name = "austin" AND job.req_exp = 5
what jobs in austin require 10 years of experience ?	SELECT DISTINCT job.job_id FROM job JOIN city ON job.job_id = city.job_id WHERE city.city_name = "austin" AND job.req_exp = 10
give me the jobs for a database specialist in usa ?	SELECT DISTINCT job.job_id FROM job JOIN area ON job.job_id = area.job_id JOIN country ON job.job_id = country.job_id WHERE area.area = "database" AND country.country = "usa"
show the jobs requiring bs in usa ?	SELECT DISTINCT job.job_id FROM job JOIN country ON job.job_id = country.job_id WHERE job.req_deg = "BS" AND country.country = "usa"
what job is there for a bscs with 5 years of experience ?	SELECT DISTINCT job.job_id FROM job WHERE job.req_deg = "BSCS" AND job.req_exp = 5
what jobs require at least 1 year of experience in 'c++' ?	SELECT DISTINCT job.job_id FROM job JOIN language ON job.job_id = language.job_id WHERE job.req_exp = 1 AND language.language = "c++"
what jobs in austin require no experience ?	SELECT DISTINCT job.job_id FROM job JOIN city ON job.job_id = city.job_id WHERE city.city_name = "austin" AND job.req_exp is NULL
what jobs in austin require no experience ?	SELECT DISTINCT job.job_id FROM job JOIN city ON job.job_id = city.job_id WHERE city.city_name = "austin" AND job.req_exp is NULL
give some jobs in dallas on a sun system ?	SELECT DISTINCT job.job_id FROM job JOIN city ON job.job_id = city.job_id JOIN platform ON job.job_id = platform.job_id WHERE city.city_name = "dallas" AND platform.platform = "sun"
show jobs in austin that require a bscs ?	SELECT DISTINCT job.job_id FROM job JOIN city ON job.job_id = city.job_id WHERE city.city_name = "austin" AND job.req_deg = "BSCS"
what jobs are there in dallas that requires a mscs ?	SELECT DISTINCT job.job_id FROM job JOIN city ON job.job_id = city.job_id WHERE city.city_name = "dallas" AND job.req_deg = "MSCS"
whats available on vax and near austin ?	SELECT DISTINCT job.job_id FROM job JOIN city ON job.job_id = city.job_id JOIN platform ON job.job_id = platform.job_id WHERE platform.platform = "vax" AND city.city_name = "austin"
show me the jobs at companies in austin that want a degree in bscs	SELECT DISTINCT job.job_id FROM job JOIN city ON job.job_id = city.job_id WHERE city.city_name = "austin" AND job.des_deg = "BSCS"
find all network administration jobs in austin ?	SELECT DISTINCT job.job_id FROM job JOIN area ON job.job_id = area.job_id JOIN city ON job.job_id = city.job_id WHERE area.area = "network" AND city.city_name = "austin"
show me austin jobs requiring a bscs ?	SELECT DISTINCT job.job_id FROM job JOIN city ON job.job_id = city.job_id WHERE city.city_name = "austin" AND job.req_deg = "BSCS"
what 'c++' jobs are in austin ?	SELECT DISTINCT job.job_id FROM job JOIN city ON job.job_id = city.job_id JOIN language ON job.job_id = language.job_id WHERE language.language = "c++" AND city.city_name = "austin"
show me austin jobs desiring a bscs	SELECT DISTINCT job.job_id FROM job JOIN city ON job.job_id = city.job_id WHERE city.city_name = "austin" AND job.des_deg = "BSCS"
show jobs in austin that require a bscs ?	SELECT DISTINCT job.job_id FROM job JOIN city ON job.job_id = city.job_id WHERE city.city_name = "austin" AND job.req_deg = "BSCS"
what jobs in boston have openings for a 'c++' programmer ?	SELECT DISTINCT job.job_id FROM job JOIN city ON job.job_id = city.job_id JOIN language ON job.job_id = language.job_id WHERE city.city_name = "boston" AND language.language = "c++"
find all network administration jobs in austin ?	SELECT DISTINCT job.job_id FROM job JOIN area ON job.job_id = area.job_id JOIN city ON job.job_id = city.job_id WHERE area.area = "network" AND city.city_name = "austin"
what jobs in boston have openings for a 'c++' programmer ?	SELECT DISTINCT job.job_id FROM job JOIN city ON job.job_id = city.job_id JOIN language ON job.job_id = language.job_id WHERE city.city_name = "boston" AND language.language = "c++"
show me the jobs at companies in austin that want a degree in bscs	SELECT DISTINCT job.job_id FROM job JOIN city ON job.job_id = city.job_id WHERE city.city_name = "austin" AND job.des_deg = "BSCS"
find all 'c++' jobs in austin ?	SELECT DISTINCT job.job_id FROM job JOIN city ON job.job_id = city.job_id JOIN language ON job.job_id = language.job_id WHERE language.language = "c++" AND city.city_name = "austin"
what 'c++' jobs are in austin ?	SELECT DISTINCT job.job_id FROM job JOIN city ON job.job_id = city.job_id JOIN language ON job.job_id = language.job_id WHERE language.language = "c++" AND city.city_name = "austin"
i hold a degree in bscs in austin are there any jobs for me ?	SELECT DISTINCT job.job_id FROM job JOIN city ON job.job_id = city.job_id WHERE job.des_deg = "BSCS" AND city.city_name = "austin"
show me dallas jobs requiring a bscs ?	SELECT DISTINCT job.job_id FROM job JOIN city ON job.job_id = city.job_id WHERE city.city_name = "dallas" AND job.req_deg = "BSCS"
what jobs are there in austin that require a bscs degree ?	SELECT DISTINCT job.job_id FROM job JOIN city ON job.job_id = city.job_id WHERE city.city_name = "austin" AND job.req_deg = "BSCS"
i wish there were some perl jobs in boston ?	SELECT DISTINCT job.job_id FROM job JOIN city ON job.job_id = city.job_id JOIN language ON job.job_id = language.job_id WHERE language.language = "perl" AND city.city_name = "boston"
show me the jobs requiring 3 years of experience at tivoli ?	SELECT DISTINCT job.job_id FROM job WHERE job.req_exp = 3 AND job.company = "Tivoli"
what jobs in austin require knowledge of the platform unix ?	SELECT DISTINCT job.job_id FROM job JOIN city ON job.job_id = city.job_id JOIN platform ON job.job_id = platform.job_id WHERE city.city_name = "austin" AND platform.platform = "unix"
what jobs in austin need knowledge in unix ?	SELECT DISTINCT job.job_id FROM job JOIN city ON job.job_id = city.job_id JOIN platform ON job.job_id = platform.job_id WHERE city.city_name = "austin" AND platform.platform = "unix"
what are the jobs in washington that require at least 5 years of experience ?	SELECT DISTINCT job.job_id FROM job JOIN city ON job.job_id = city.job_id WHERE city.city_name = "washington" AND job.req_exp = 5
list the jobs using html for a games specialist ?	SELECT DISTINCT job.job_id FROM job JOIN area ON job.job_id = area.job_id JOIN language ON job.job_id = language.job_id WHERE language.language = "html" AND area.area = "games"
what jobs in houston require a bacs ?	SELECT DISTINCT job.job_id FROM job JOIN city ON job.job_id = city.job_id WHERE city.city_name = "houston" AND job.req_deg = "BACS"
show the jobs on pc requiring bscs ?	SELECT DISTINCT job.job_id FROM job JOIN platform ON job.job_id = platform.job_id WHERE platform.platform = "pc" AND job.req_deg = "BSCS"
what jobs require a bscs and no experience ?	SELECT DISTINCT job.job_id FROM job WHERE job.req_deg = "BSCS" AND job.req_exp is NULL
do you have any jobs involving 'c++' on aix ?	SELECT DISTINCT job.job_id FROM job JOIN language ON job.job_id = language.job_id JOIN platform ON job.job_id = platform.job_id WHERE language.language = "c++" AND platform.platform = "aix"
are there any jobs using 'c++' with dell ?	SELECT DISTINCT job.job_id FROM job JOIN language ON job.job_id = language.job_id WHERE language.language = "c++" AND job.company = "Dell"
tell me the jobs requiring ba using cobol ?	SELECT DISTINCT job.job_id FROM job JOIN language ON job.job_id = language.job_id WHERE job.req_deg = "BA" AND language.language = "cobol"
what jobs require a bscs degree and desire an mscs degree ?	SELECT DISTINCT job.job_id FROM job WHERE job.req_deg = "BSCS" AND job.des_deg = "MSCS"
what jobs at dell require a bscs ?	SELECT DISTINCT job.job_id FROM job WHERE job.company = "Dell" AND job.req_deg = "BSCS"
are there any jobs using assembly in usa ?	SELECT DISTINCT job.job_id FROM job JOIN country ON job.job_id = country.job_id JOIN language ON job.job_id = language.job_id WHERE language.language = "assembly" AND country.country = "usa"
are there any jobs using 'c++' with dell ?	SELECT DISTINCT job.job_id FROM job JOIN language ON job.job_id = language.job_id WHERE language.language = "c++" AND job.company = "Dell"
give me jobs on vms using sql ?	SELECT DISTINCT job.job_id FROM job JOIN language ON job.job_id = language.job_id JOIN platform ON job.job_id = platform.job_id WHERE platform.platform = "vms" AND language.language = "sql"
show me jobs at dell requiring a bscs degree ?	SELECT DISTINCT job.job_id FROM job WHERE job.company = "Dell" AND job.req_deg = "BSCS"
show me jobs requiring a bscs on sun ?	SELECT DISTINCT job.job_id FROM job JOIN platform ON job.job_id = platform.job_id WHERE job.req_deg = "BSCS" AND platform.platform = "sun"
show me jobs requiring a bscs on suns ?	SELECT DISTINCT job.job_id FROM job JOIN platform ON job.job_id = platform.job_id WHERE job.req_deg = "BSCS" AND platform.platform = "sun"
what jobs are there that dont require a degree but use perl ?	SELECT DISTINCT job.job_id FROM job JOIN language ON job.job_id = language.job_id WHERE job.req_deg is NULL AND language.language = "perl"
what jobs use html but do not require a degree ?	SELECT DISTINCT job.job_id FROM job JOIN language ON job.job_id = language.job_id WHERE language.language = "html" AND job.req_deg is NULL
show the jobs with the title systems programmer requiring 2 years of experience	SELECT DISTINCT job.job_id FROM job WHERE job.title = "Programmer" AND job.req_exp = 2
show me programmer jobs in tulsa ?	SELECT DISTINCT job.job_id FROM job JOIN city ON job.job_id = city.job_id WHERE job.title = "Programmer" AND city.city_name = "tulsa"
show me the jobs using lisp requiring a bscs ?	SELECT DISTINCT job.job_id FROM job JOIN language ON job.job_id = language.job_id WHERE language.language = "lisp" AND job.req_deg = "BSCS"
give me jobs on the mac using perl ?	SELECT DISTINCT job.job_id FROM job JOIN language ON job.job_id = language.job_id JOIN platform ON job.job_id = platform.job_id WHERE platform.platform = "mac" AND language.language = "perl"
list jobs requiring bscs using java ?	SELECT DISTINCT job.job_id FROM job JOIN language ON job.job_id = language.job_id WHERE job.req_deg = "BSCS" AND language.language = "java"
show me programmer jobs in tulsa ?	SELECT DISTINCT job.job_id FROM job JOIN city ON job.job_id = city.job_id WHERE job.title = "Programmer" AND city.city_name = "tulsa"
what positions are there that use 'c++' and java ?	SELECT DISTINCT job.job_id FROM job JOIN language ON job.job_id = language.job_id WHERE language.language = "c++" AND language.language = "java"
show me the jobs using lisp requiring a bscs ?	SELECT DISTINCT job.job_id FROM job JOIN language ON job.job_id = language.job_id WHERE language.language = "lisp" AND job.req_deg = "BSCS"
where can i work with a bscs and no experience ?	SELECT DISTINCT city.city_name FROM job JOIN city ON job.job_id = city.job_id WHERE job.req_deg = "BSCS" AND job.req_exp is NULL
show me new york jobs requiring a bscs ?	SELECT DISTINCT job.job_id FROM job JOIN city ON job.job_id = city.job_id WHERE city.city_name = "new york" AND job.req_deg = "BSCS"
what tivoli jobs are there that require a bscs degree ?	SELECT DISTINCT job.job_id FROM job WHERE job.company = "Tivoli" AND job.req_deg = "BSCS"
which jobs at trilogy deal with 'c++' ?	SELECT DISTINCT job.job_id FROM job JOIN language ON job.job_id = language.job_id WHERE job.company = "Trilogy" AND language.language = "c++"
show jobs for a shell programmer familiar with the unix environment ?	SELECT DISTINCT job.job_id FROM job JOIN language ON job.job_id = language.job_id JOIN platform ON job.job_id = platform.job_id WHERE language.language = "shell" AND platform.platform = "unix"
what jobs using fortran are there in houston ?	SELECT DISTINCT job.job_id FROM job JOIN city ON job.job_id = city.job_id JOIN language ON job.job_id = language.job_id WHERE language.language = "fortran" AND city.city_name = "houston"
which jobs at trilogy deal with 'c++' ?	SELECT DISTINCT job.job_id FROM job JOIN language ON job.job_id = language.job_id WHERE job.company = "Trilogy" AND language.language = "c++"
show a list of jobs requiring experience in 'c++' or java ?	SELECT DISTINCT job.job_id FROM job JOIN language ON job.job_id = language.job_id WHERE (language.language = "c++" OR language.language = "java") AND job.req_exp is not NULL
is anyone offering 40000 for ai work ?	SELECT DISTINCT job.job_id FROM job JOIN area ON job.job_id = area.job_id JOIN salary ON job.job_id = salary.job_id WHERE salary.money >= 40000 AND salary.time = "year" AND area.area = "ai"
what are the jobs in austin requiring knowledge of oracle ?	SELECT DISTINCT job.job_id FROM job JOIN application ON job.job_id = application.job_id JOIN city ON job.job_id = city.job_id WHERE city.city_name = "austin" AND application.application = "oracle"
show the companies that are looking for bscs in austin	SELECT DISTINCT job.company FROM job JOIN city ON job.job_id = city.job_id WHERE job.req_deg = "BSCS" AND city.city_name = "austin"
are there any mac programmer jobs ?	SELECT DISTINCT job.job_id FROM job JOIN platform ON job.job_id = platform.job_id WHERE platform.platform = "mac" AND job.title = "Programmer"
are there any mac programmer jobs ?	SELECT DISTINCT job.job_id FROM job JOIN platform ON job.job_id = platform.job_id WHERE platform.platform = "mac" AND job.title = "Programmer"
what jobs are there in austin for people with knowledge of the application oracle ?	SELECT DISTINCT job.job_id FROM job JOIN application ON job.job_id = application.job_id JOIN city ON job.job_id = city.job_id WHERE city.city_name = "austin" AND application.application = "oracle"
what jobs are there for assembly programmer that require a bscs ?	SELECT DISTINCT job.job_id FROM job JOIN language ON job.job_id = language.job_id WHERE language.language = "assembly" AND job.req_deg = "BSCS"
are there any jobs using java that are not with ibm ?	SELECT DISTINCT job.job_id FROM job JOIN language ON job.job_id = language.job_id WHERE language.language = "java" AND job.company != "IBM"
what jobs are there for programmers who know java ?	SELECT DISTINCT job.job_id FROM job JOIN language ON job.job_id = language.job_id WHERE job.title = "Programmer" AND language.language = "java"
i sure do wish there were java assembly jobs out there '.' can you help ?	SELECT DISTINCT job.job_id FROM job JOIN language ON job.job_id = language.job_id WHERE language.language = "java" AND language.language = "assembly"
could i have some jobs using sql with oracle ?	SELECT DISTINCT job.job_id FROM job JOIN application ON job.job_id = application.job_id JOIN language ON job.job_id = language.job_id WHERE language.language = "sql" AND application.application = "oracle"
show me the jobs concerning games development on a playstation ?	SELECT DISTINCT job.job_id FROM job JOIN area ON job.job_id = area.job_id JOIN platform ON job.job_id = platform.job_id WHERE area.area = "games" AND platform.platform = "playstation"
are there any jobs using java that dont require a bscs ?	SELECT DISTINCT job.job_id FROM job JOIN language ON job.job_id = language.job_id WHERE language.language = "java" AND job.req_deg != "BSCS"
show the jobs using lisp not requiring a bscs	SELECT DISTINCT job.job_id FROM job JOIN language ON job.job_id = language.job_id WHERE language.language = "lisp" AND job.req_deg != "BSCS"
what jobs require knowledge of 'c++' but not perl ?	SELECT DISTINCT job.job_id FROM job JOIN language ON job.job_id = language.job_id WHERE language.language = "c++" AND language.language != "perl"
what jobs require knowledge of 'c++' but not perl ?	SELECT DISTINCT job.job_id FROM job JOIN language ON job.job_id = language.job_id WHERE language.language = "c++" AND language.language != "perl"
show the jobs using lisp not requiring a degree in cs ?	SELECT DISTINCT job.job_id FROM job JOIN language ON job.job_id = language.job_id WHERE language.language = "lisp" AND job.req_deg != "BSCS"
show me austin jobs with a salary of 50000	SELECT DISTINCT job.job_id FROM job JOIN city ON job.job_id = city.job_id JOIN salary ON job.job_id = salary.job_id WHERE city.city_name = "austin" AND salary.money >= 50000 AND salary.time = "year"
what jobs in austin have a salary of 60000 ?	SELECT DISTINCT job.job_id FROM job JOIN city ON job.job_id = city.job_id JOIN salary ON job.job_id = salary.job_id WHERE city.city_name = "austin" AND salary.money >= 60000 AND salary.time = "year"
what jobs in austin have a salary of 60000 ?	SELECT DISTINCT job.job_id FROM job JOIN city ON job.job_id = city.job_id JOIN salary ON job.job_id = salary.job_id WHERE city.city_name = "austin" AND salary.money >= 60000 AND salary.time = "year"
what are the positions within hp that pay 40000 per year ?	SELECT DISTINCT job.job_id FROM job JOIN salary ON job.job_id = salary.job_id WHERE job.company = "HP" AND salary.money >= 40000 AND salary.time = "year"
what are the positions within hp that pay 40000 per year ?	SELECT DISTINCT job.job_id FROM job JOIN salary ON job.job_id = salary.job_id WHERE job.company = "HP" AND salary.money >= 40000 AND salary.time = "year"
show me austin jobs with a salary of 50000	SELECT DISTINCT job.job_id FROM job JOIN city ON job.job_id = city.job_id JOIN salary ON job.job_id = salary.job_id WHERE city.city_name = "austin" AND salary.money >= 50000 AND salary.time = "year"
give me jobs in san antonio using cobol ?	SELECT DISTINCT job.job_id FROM job JOIN city ON job.job_id = city.job_id JOIN language ON job.job_id = language.job_id WHERE city.city_name = "san antonio" AND language.language = "cobol"
what web developer jobs are there in austin ?	SELECT DISTINCT job.job_id FROM job JOIN city ON job.job_id = city.job_id WHERE job.title = "Web Developer" AND city.city_name = "austin"
are there any jobs that require a knowledge of linux in san antonio ?	SELECT DISTINCT job.job_id FROM job JOIN city ON job.job_id = city.job_id JOIN platform ON job.job_id = platform.job_id WHERE platform.platform = "linux" AND city.city_name = "san antonio"
what jobs in san antonio require the use of cobol ?	SELECT DISTINCT job.job_id FROM job JOIN city ON job.job_id = city.job_id JOIN language ON job.job_id = language.job_id WHERE city.city_name = "san antonio" AND language.language = "cobol"
what jobs are there in austin with a salary of at least 100000 per year ?	SELECT DISTINCT job.job_id FROM job JOIN city ON job.job_id = city.job_id JOIN salary ON job.job_id = salary.job_id WHERE city.city_name = "austin" AND salary.money >= 100000 AND salary.time = "year"
are there any jobs in austin paying over 100000 per year ?	SELECT DISTINCT job.job_id FROM job JOIN city ON job.job_id = city.job_id JOIN salary ON job.job_id = salary.job_id WHERE city.city_name = "austin" AND salary.money >= 100000 AND salary.time = "year"
what jobs using fortran are there in los alamos ?	SELECT DISTINCT job.job_id FROM job JOIN city ON job.job_id = city.job_id JOIN language ON job.job_id = language.job_id WHERE language.language = "fortran" AND city.city_name = "los alamos"
show the jobs with the title systems analyst requiring 2 years of experience ?	SELECT DISTINCT job.job_id FROM job WHERE job.title = "Systems Analyst" AND job.req_exp = 2
what jobs are there for pascal programers who dont know 'c++'	SELECT DISTINCT job.job_id FROM job JOIN language ON job.job_id = language.job_id WHERE language.language = "pascal" AND language.language != "c++"
are there any jobs using java that are not with tivoli ?	SELECT DISTINCT job.job_id FROM job JOIN language ON job.job_id = language.job_id WHERE language.language = "java" AND job.company != "Tivoli"
what jobs in dallas require experience with unix ?	SELECT DISTINCT job.job_id FROM job JOIN city ON job.job_id = city.job_id JOIN platform ON job.job_id = platform.job_id WHERE city.city_name = "dallas" AND platform.platform = "unix" AND job.req_exp is not NULL
what jobs are there in austin that requires experience with unix ?	SELECT DISTINCT job.job_id FROM job JOIN city ON job.job_id = city.job_id JOIN platform ON job.job_id = platform.job_id WHERE city.city_name = "austin" AND platform.platform = "unix" AND job.req_exp is not NULL
what locations offer jobs using java on sun ?	SELECT DISTINCT city.city_name FROM job JOIN city ON job.job_id = city.job_id JOIN language ON job.job_id = language.job_id JOIN platform ON job.job_id = platform.job_id WHERE language.language = "java" AND platform.platform = "sun"
can i find a job making more than 40000 a year without a degree ?	SELECT DISTINCT job.job_id FROM job JOIN salary ON job.job_id = salary.job_id WHERE salary.money >= 40000 AND salary.time = "year" AND job.req_deg is NULL
what jobs do not require a degree but pay more than 60000 ?	SELECT DISTINCT job.job_id FROM job JOIN salary ON job.job_id = salary.job_id WHERE job.req_deg is NULL AND salary.money >= 60000 AND salary.time = "year"
are there any jobs in 'c++' that the salary is 50000 ?	SELECT DISTINCT job.job_id FROM job JOIN language ON job.job_id = language.job_id JOIN salary ON job.job_id = salary.job_id WHERE language.language = "c++" AND salary.money >= 50000 AND salary.time = "year"
what jobs pay 40000 per year that require a bscs ?	SELECT DISTINCT job.job_id FROM job JOIN salary ON job.job_id = salary.job_id WHERE salary.money >= 40000 AND salary.time = "year" AND job.req_deg = "BSCS"
show me jobs at dell earning 60000	SELECT DISTINCT job.job_id FROM job JOIN salary ON job.job_id = salary.job_id WHERE job.company = "Dell" AND salary.money >= 60000 AND salary.time = "year"
what are the jobs using 'c++' with salaries of 50000 ?	SELECT DISTINCT job.job_id FROM job JOIN language ON job.job_id = language.job_id JOIN salary ON job.job_id = salary.job_id WHERE language.language = "c++" AND salary.money >= 50000 AND salary.time = "year"
can you offer anything with at least 60000 on a sun ?	SELECT DISTINCT job.job_id FROM job JOIN platform ON job.job_id = platform.job_id JOIN salary ON job.job_id = salary.job_id WHERE salary.money >= 60000 AND salary.time = "year" AND platform.platform = "sun"
what do you have paying over 40000 on the vax ?	SELECT DISTINCT job.job_id FROM job JOIN platform ON job.job_id = platform.job_id JOIN salary ON job.job_id = salary.job_id WHERE salary.money >= 40000 AND salary.time = "year" AND platform.platform = "vax"
what jobs pay 40000 per year that desire a bscs ?	SELECT DISTINCT job.job_id FROM job JOIN salary ON job.job_id = salary.job_id WHERE salary.money >= 40000 AND salary.time = "year" AND job.des_deg = "BSCS"
what jobs require 'c++' and pays a salary greater than 90000 per year ?	SELECT DISTINCT job.job_id FROM job JOIN language ON job.job_id = language.job_id JOIN salary ON job.job_id = salary.job_id WHERE language.language = "c++" AND salary.money >= 90000 AND salary.time = "year"
what jobs are there for web developer who know 'c++' ?	SELECT DISTINCT job.job_id FROM job JOIN language ON job.job_id = language.job_id WHERE job.title = "Web Developer" AND language.language = "c++"
what jobs are there outside austin which pay less than 60000 per year ?	SELECT DISTINCT job.job_id FROM job JOIN city ON job.job_id = city.job_id JOIN salary ON job.job_id = salary.job_id WHERE city.city_name != "austin" AND salary.money <= 60000 AND salary.time = "year"
what jobs are available using apache with a specialty area of networking ?	SELECT DISTINCT job.job_id FROM job JOIN application ON job.job_id = application.job_id JOIN area ON job.job_id = area.job_id WHERE application.application = "apache" AND area.area = "networking"
what jobs are there for web developer who know 'c++' ?	SELECT DISTINCT job.job_id FROM job JOIN language ON job.job_id = language.job_id WHERE job.title = "Web Developer" AND language.language = "c++"
what systems analyst jobs are there in austin ?	SELECT DISTINCT job.job_id FROM job JOIN city ON job.job_id = city.job_id WHERE job.title = "Systems Analyst" AND city.city_name = "austin"
give me 'c++' jobs on windows nt ?	SELECT DISTINCT job.job_id FROM job JOIN language ON job.job_id = language.job_id JOIN platform ON job.job_id = platform.job_id WHERE platform.platform = "windows nt" AND language.language = "c++"
what jobs are available using apache with a specialty area of networking ?	SELECT DISTINCT job.job_id FROM job JOIN application ON job.job_id = application.job_id JOIN area ON job.job_id = area.job_id WHERE application.application = "apache" AND area.area = "networking"
give me the jobs using 'c++' that dont require windows ?	SELECT DISTINCT job.job_id FROM job JOIN language ON job.job_id = language.job_id JOIN platform ON job.job_id = platform.job_id WHERE language.language = "c++" AND platform.platform != "windows"
what jobs are there for programmers that know assembly ?	SELECT DISTINCT job.job_id FROM job JOIN language ON job.job_id = language.job_id WHERE job.title = "Programmer" AND language.language = "assembly"
what jobs are in seattle that are not at microsoft ?	SELECT DISTINCT job.job_id FROM job JOIN city ON job.job_id = city.job_id WHERE city.city_name = "seattle" AND job.company != "Microsoft"
show me the jobs using java with salaries greater than 50000	SELECT DISTINCT job.job_id FROM job JOIN language ON job.job_id = language.job_id JOIN salary ON job.job_id = salary.job_id WHERE language.language = "java" AND salary.money >= 50000 AND salary.time = "year"
what jobs are there for a test engineer using java ?	SELECT DISTINCT job.job_id FROM job JOIN language ON job.job_id = language.job_id WHERE job.title = "Test Engineer" AND language.language = "java"
show me systems analyst jobs at ibm ?	SELECT DISTINCT job.job_id FROM job WHERE job.title = "Systems Analyst" AND job.company = "IBM"
show me jobs with the playstation in the specialty area of animation ?	SELECT DISTINCT job.job_id FROM job JOIN area ON job.job_id = area.job_id JOIN platform ON job.job_id = platform.job_id WHERE platform.platform = "playstation" AND area.area = "animation"
what microsoft jobs do not require a bscs ?	SELECT DISTINCT job.job_id FROM job WHERE job.company = "Microsoft" AND job.req_deg != "BSCS"
what microsoft jobs do not require a bscs ?	SELECT DISTINCT job.job_id FROM job WHERE job.company = "Microsoft" AND job.req_deg != "BSCS"
what jobs are available for someone who knows oracle on solaris ?	SELECT DISTINCT job.job_id FROM job JOIN application ON job.job_id = application.job_id JOIN platform ON job.job_id = platform.job_id WHERE platform.platform = "solaris" AND application.application = "oracle"
show me jobs are dell requiring experience on unix ?	SELECT DISTINCT job.job_id FROM job JOIN platform ON job.job_id = platform.job_id WHERE job.company = "Dell" AND platform.platform = "unix" AND job.req_exp is not NULL
show me jobs for dell requiring experience on unix ?	SELECT DISTINCT job.job_id FROM job JOIN platform ON job.job_id = platform.job_id WHERE job.company = "Dell" AND platform.platform = "unix" AND job.req_exp is not NULL
show me all of the software engineer jobs in austin ?	SELECT DISTINCT job.job_id FROM job JOIN city ON job.job_id = city.job_id WHERE job.title = "Software Engineer" AND city.city_name = "austin"
show me graphics jobs which phil smith is recruiting for ?	SELECT DISTINCT job.job_id FROM job JOIN area ON job.job_id = area.job_id WHERE area.area = "graphics" AND job.recruiter = "Phil Smith"
show me graphics jobs which phil smith is recruiting for ?	SELECT DISTINCT job.job_id FROM job JOIN area ON job.job_id = area.job_id WHERE area.area = "graphics" AND job.recruiter = "Phil Smith"
are there any software developer jobs requiring bs ?	SELECT DISTINCT job.job_id FROM job WHERE job.title = "Software Developer" AND job.req_deg = "BS"
show me the research assistant job in austin	SELECT DISTINCT job.job_id FROM job JOIN city ON job.job_id = city.job_id WHERE job.title = "research assistant" AND city.city_name = "austin"
show me the research assistant job in austin	SELECT DISTINCT job.job_id FROM job JOIN city ON job.job_id = city.job_id WHERE job.title = "research assistant" AND city.city_name = "austin"
show me web developer job openings at trilogy ?	SELECT DISTINCT job.job_id FROM job WHERE job.title = "Web Developer" AND job.company = "Trilogy"
show me developer jobs requiring experience with mac ?	SELECT DISTINCT job.job_id FROM job JOIN platform ON job.job_id = platform.job_id WHERE job.title = "Developer" AND platform.platform = "mac" AND job.req_exp is not NULL
who gives 50000 for fortran ?	SELECT DISTINCT job.job_id FROM job JOIN language ON job.job_id = language.job_id JOIN salary ON job.job_id = salary.job_id WHERE salary.money >= 50000 AND salary.time = "year" AND language.language = "fortran"
which jobs pay 60000 that do not require a phd ?	SELECT DISTINCT job.job_id FROM job JOIN salary ON job.job_id = salary.job_id WHERE salary.money >= 60000 AND salary.time = "year" AND job.req_deg != "PhD"
what are the software engineering jobs available using ada ?	SELECT DISTINCT job.job_id FROM job JOIN language ON job.job_id = language.job_id WHERE language.language = "ada" AND job.title = "Software Engineer"
what software engineer jobs are there that use 'c++' ?	SELECT DISTINCT job.job_id FROM job JOIN language ON job.job_id = language.job_id WHERE job.title = "Software Engineer" AND language.language = "c++"
show me systems analyst jobs at tivoli ?	SELECT DISTINCT job.job_id FROM job WHERE job.title = "Systems Analyst" AND job.company = "Tivoli"
what are the software engineer jobs available using ada ?	SELECT DISTINCT job.job_id FROM job JOIN language ON job.job_id = language.job_id WHERE job.title = "Software Engineer" AND language.language = "ada"
does apple have any software engineer positions ?	SELECT DISTINCT job.job_id FROM job WHERE job.company = "Apple" AND job.title = "Software Engineer"
what jobs are there for a visual basic developer ?	SELECT DISTINCT job.job_id FROM job JOIN language ON job.job_id = language.job_id WHERE language.language = "visual basic" AND job.title = "Developer"
what job is there for 'c++' but not visual 'c++' ?	SELECT DISTINCT job.job_id FROM job JOIN language ON job.job_id = language.job_id WHERE language.language = "c++" AND language.language != "visual c++"
are there any systems administrator jobs in austin ?	SELECT DISTINCT job.job_id FROM job JOIN city ON job.job_id = city.job_id WHERE job.title = "Systems Administrator" AND city.city_name = "austin"
what programming languages are desired for a job as a programmer at ibm ?	SELECT DISTINCT language.language FROM job JOIN language ON job.job_id = language.job_id WHERE job.title = "Programmer" AND job.company = "IBM"
what jobs require a bscs and experience with oracle ?	SELECT DISTINCT job.job_id FROM job JOIN application ON job.job_id = application.job_id WHERE job.req_deg = "BSCS" AND application.application = "oracle" AND job.req_exp is not NULL
what system administrator jobs are available from dell ?	SELECT DISTINCT job.job_id FROM job WHERE job.title = "System Administrator" AND job.company = "Dell"
what jobs pay 60000 are located in austin and require a degree ?	SELECT DISTINCT job.job_id FROM job JOIN city ON job.job_id = city.job_id JOIN salary ON job.job_id = salary.job_id WHERE salary.money >= 60000 AND salary.time = "year" AND city.city_name = "austin" AND job.req_deg is not NULL
what jobs are there doing computer graphics on silicon graphics machines ?	SELECT DISTINCT job.job_id FROM job JOIN area ON job.job_id = area.job_id JOIN platform ON job.job_id = platform.job_id WHERE area.area = "graphics" AND platform.platform = "silicon graphics"
what system administrator jobs are available from dell ?	SELECT DISTINCT job.job_id FROM job WHERE job.title = "System Administrator" AND job.company = "Dell"
give me jobs that require ethernet experience but no html ?	SELECT DISTINCT job.job_id FROM job JOIN area ON job.job_id = area.job_id JOIN language ON job.job_id = language.job_id WHERE area.area = "ethernet" AND language.language != "html" AND job.req_exp is not NULL
what jobs in austin require 5 years of experience but desire 10 years of experience ?	SELECT DISTINCT job.job_id FROM job JOIN city ON job.job_id = city.job_id WHERE city.city_name = "austin" AND job.req_exp = 5 AND job.des_exp = 10
show me the jobs in texas using ai on unix ?	SELECT DISTINCT job.job_id FROM job JOIN area ON job.job_id = area.job_id JOIN city ON job.job_id = city.job_id JOIN platform ON job.job_id = platform.job_id WHERE city.city_name = "texas" AND area.area = "ai" AND platform.platform = "unix"
show me the jobs in texas using ai on unix ?	SELECT DISTINCT job.job_id FROM job JOIN area ON job.job_id = area.job_id JOIN city ON job.job_id = city.job_id JOIN platform ON job.job_id = platform.job_id WHERE city.city_name = "texas" AND area.area = "ai" AND platform.platform = "unix"
what jobs in austin require 5 years of experience but desire 10 years of experience ?	SELECT DISTINCT job.job_id FROM job JOIN city ON job.job_id = city.job_id WHERE city.city_name = "austin" AND job.req_exp = 5 AND job.des_exp = 10
what jobs require a degree for pascal programmers who do not know 'c++' ?	SELECT DISTINCT job.job_id FROM job JOIN language ON job.job_id = language.job_id WHERE language.language = "pascal" AND language.language != "c++" AND job.req_deg is not NULL
does national instruments have any positions that dont require experience ?	SELECT DISTINCT job.job_id FROM job WHERE job.company = "National Instruments" AND job.req_exp is NULL
does national instruments have any positions that dont require experience ?	SELECT DISTINCT job.job_id FROM job WHERE job.company = "National Instruments" AND job.req_exp is NULL
what jobs as an sql engineer pay 100000 ?	SELECT DISTINCT job.job_id FROM job JOIN salary ON job.job_id = salary.job_id WHERE job.title = "Sql Engineer" AND salary.money >= 100000 AND salary.time = "year"
show me the jobs in austin that desire 3 years of experience and use 'c++' ?	SELECT DISTINCT job.job_id FROM job JOIN city ON job.job_id = city.job_id JOIN language ON job.job_id = language.job_id WHERE city.city_name = "austin" AND job.des_exp = 3 AND language.language = "c++"
show me the jobs in austin that desire 3 years of experience and use 'c++' ?	SELECT DISTINCT job.job_id FROM job JOIN city ON job.job_id = city.job_id JOIN language ON job.job_id = language.job_id WHERE city.city_name = "austin" AND job.des_exp = 3 AND language.language = "c++"
what web related jobs require a bscs but no experience ?	SELECT DISTINCT job.job_id FROM job JOIN area ON job.job_id = area.job_id WHERE area.area = "web" AND job.req_deg = "BSCS" AND job.req_exp is NULL
show me programmer jobs requiring no experience on unix ?	SELECT DISTINCT job.job_id FROM job JOIN platform ON job.job_id = platform.job_id WHERE job.title = "Programmer" AND platform.platform = "unix" AND job.req_exp is NULL
what jobs in houston are there that requires a bscs with 1 year of experience ?	SELECT DISTINCT job.job_id FROM job JOIN city ON job.job_id = city.job_id WHERE city.city_name = "houston" AND job.req_deg = "BSCS" AND job.req_exp = 1
what jobs use 'c++' with the web on macs ?	SELECT DISTINCT job.job_id FROM job JOIN area ON job.job_id = area.job_id JOIN language ON job.job_id = language.job_id JOIN platform ON job.job_id = platform.job_id WHERE language.language = "c++" AND area.area = "web" AND platform.platform = "mac"
what jobs in ibm in austin do not need a degree ?	SELECT DISTINCT job.job_id FROM job JOIN city ON job.job_id = city.job_id WHERE job.company = "IBM" AND city.city_name = "austin" AND job.req_deg is NULL
could a senior consulting engineer find work in boston ?	SELECT DISTINCT job.job_id FROM job JOIN city ON job.job_id = city.job_id WHERE job.title = "Senior Consulting Engineer" AND city.city_name = "boston"
what jobs in austin require a bscs degree and deal with 'tcp/ip' ?	SELECT DISTINCT job.job_id FROM job JOIN area ON job.job_id = area.job_id JOIN city ON job.job_id = city.job_id WHERE city.city_name = "austin" AND job.req_deg = "BSCS" AND area.area = "tcp/ip"
what jobs in austin only require a bscs and no experience ?	SELECT DISTINCT job.job_id FROM job JOIN city ON job.job_id = city.job_id WHERE city.city_name = "austin" AND job.req_deg = "BSCS" AND job.req_exp is NULL
what jobs are there in texas that use java and require no experience ?	SELECT DISTINCT job.job_id FROM job JOIN city ON job.job_id = city.job_id JOIN language ON job.job_id = language.job_id WHERE city.city_name = "texas" AND language.language = "java" AND job.req_exp is NULL
what jobs are there in texas that use java and require no experience ?	SELECT DISTINCT job.job_id FROM job JOIN city ON job.job_id = city.job_id JOIN language ON job.job_id = language.job_id WHERE city.city_name = "texas" AND language.language = "java" AND job.req_exp is NULL
show me 'c++' jobs requiring a bscs in austin ?	SELECT DISTINCT job.job_id FROM job JOIN city ON job.job_id = city.job_id JOIN language ON job.job_id = language.job_id WHERE language.language = "c++" AND job.req_deg = "BSCS" AND city.city_name = "austin"
what are the 'c++' jobs in austin requiring a bscs ?	SELECT DISTINCT job.job_id FROM job JOIN city ON job.job_id = city.job_id JOIN language ON job.job_id = language.job_id WHERE language.language = "c++" AND city.city_name = "austin" AND job.req_deg = "BSCS"
show me houston jobs using 'c++' on pc ?	SELECT DISTINCT job.job_id FROM job JOIN city ON job.job_id = city.job_id JOIN language ON job.job_id = language.job_id JOIN platform ON job.job_id = platform.job_id WHERE city.city_name = "houston" AND language.language = "c++" AND platform.platform = "pc"
what java jobs are there with ibm in austin ?	SELECT DISTINCT job.job_id FROM job JOIN city ON job.job_id = city.job_id JOIN language ON job.job_id = language.job_id WHERE language.language = "java" AND job.company = "IBM" AND city.city_name = "austin"
show me the 'c++' jobs in nashville that desire 2 years experience	SELECT DISTINCT job.job_id FROM job JOIN city ON job.job_id = city.job_id JOIN language ON job.job_id = language.job_id WHERE language.language = "c++" AND city.city_name = "nashville" AND job.des_exp = 2
show me a dell job in austin requiring a bscs ?	SELECT DISTINCT job.job_id FROM job JOIN city ON job.job_id = city.job_id WHERE job.company = "Dell" AND city.city_name = "austin" AND job.req_deg = "BSCS"
what are the 'c++' jobs in austin requiring a bscs ?	SELECT DISTINCT job.job_id FROM job JOIN city ON job.job_id = city.job_id JOIN language ON job.job_id = language.job_id WHERE language.language = "c++" AND city.city_name = "austin" AND job.req_deg = "BSCS"
show me 'c++' jobs requiring a bscs in austin ?	SELECT DISTINCT job.job_id FROM job JOIN city ON job.job_id = city.job_id JOIN language ON job.job_id = language.job_id WHERE language.language = "c++" AND job.req_deg = "BSCS" AND city.city_name = "austin"
list the jobs requiring java a bscs 2 years experience	SELECT DISTINCT job.job_id FROM job JOIN language ON job.job_id = language.job_id WHERE language.language = "java" AND job.req_deg = "BSCS" AND job.req_exp = 2
show me a dell job in austin requiring a bscs ?	SELECT DISTINCT job.job_id FROM job JOIN city ON job.job_id = city.job_id WHERE job.company = "Dell" AND city.city_name = "austin" AND job.req_deg = "BSCS"
what jobs in austin desiring a bscs are there for a 'c++' programmer ?	SELECT DISTINCT job.job_id FROM job JOIN city ON job.job_id = city.job_id JOIN language ON job.job_id = language.job_id WHERE city.city_name = "austin" AND job.des_deg = "BSCS" AND language.language = "c++"
are there any jobs for people in austin that want to program in lisp but do not have a degree ?	SELECT DISTINCT job.job_id FROM job JOIN city ON job.job_id = city.job_id JOIN language ON job.job_id = language.job_id WHERE city.city_name = "austin" AND language.language = "lisp" AND job.req_deg is NULL
are there any jobs for people in austin that want to program in lisp but do not have a degree ?	SELECT DISTINCT job.job_id FROM job JOIN city ON job.job_id = city.job_id JOIN language ON job.job_id = language.job_id WHERE city.city_name = "austin" AND language.language = "lisp" AND job.req_deg is NULL
show me a job that requires 'c++' and java and is in austin ?	SELECT DISTINCT job.job_id FROM job JOIN city ON job.job_id = city.job_id JOIN language ON job.job_id = language.job_id WHERE language.language = "c++" AND language.language = "java" AND city.city_name = "austin"
what jobs in austin use 'c++' and java ?	SELECT DISTINCT job.job_id FROM job JOIN city ON job.job_id = city.job_id JOIN language ON job.job_id = language.job_id WHERE city.city_name = "austin" AND language.language = "c++" AND language.language = "java"
show me jobs at dell requiring no experience and a bscs ?	SELECT DISTINCT job.job_id FROM job WHERE job.company = "Dell" AND job.req_exp is NULL AND job.req_deg = "BSCS"
what austin jobs that use cobol do not require any experience ?	SELECT DISTINCT job.job_id FROM job JOIN city ON job.job_id = city.job_id JOIN language ON job.job_id = language.job_id WHERE city.city_name = "austin" AND language.language = "cobol" AND job.req_exp is NULL
show me jobs at dell requiring no experience and a bscs ?	SELECT DISTINCT job.job_id FROM job WHERE job.company = "Dell" AND job.req_exp is NULL AND job.req_deg = "BSCS"
show me the hardware platforms associated with a netware administrator with ibm ?	SELECT DISTINCT platform.platform FROM job JOIN platform ON job.job_id = platform.job_id WHERE job.title = "NetWare Administrator" AND job.company = "IBM"
show me the senior software developer jobs which require a master ?	SELECT DISTINCT job.job_id FROM job WHERE job.title = "Senior Software Developer" AND job.req_deg = "master"
are there any jobs in austin requiring at least a bscs and knowing latex ?	SELECT DISTINCT job.job_id FROM job JOIN city ON job.job_id = city.job_id JOIN language ON job.job_id = language.job_id WHERE city.city_name = "austin" AND job.req_deg = "BSCS" AND language.language = "latex"
show me the jobs using 'c++' that require a bscs but desire a mscs ?	SELECT DISTINCT job.job_id FROM job JOIN language ON job.job_id = language.job_id WHERE language.language = "c++" AND job.req_deg = "BSCS" AND job.des_deg = "MSCS"
show me the jobs using 'c++' that require a bscs but desire a mscs ?	SELECT DISTINCT job.job_id FROM job JOIN language ON job.job_id = language.job_id WHERE language.language = "c++" AND job.req_deg = "BSCS" AND job.des_deg = "MSCS"
which jobs in austin offer for students fresh out of college in networking ?	SELECT DISTINCT job.job_id FROM job JOIN area ON job.job_id = area.job_id JOIN city ON job.job_id = city.job_id WHERE city.city_name = "austin" AND job.req_exp is NULL AND area.area = "networking"
which jobs in austin offer for students fresh out of college in networking ?	SELECT DISTINCT job.job_id FROM job JOIN area ON job.job_id = area.job_id JOIN city ON job.job_id = city.job_id WHERE city.city_name = "austin" AND job.req_exp is NULL AND area.area = "networking"
what ai jobs are there in texas that pay 65000 ?	SELECT DISTINCT job.job_id FROM job JOIN area ON job.job_id = area.job_id JOIN city ON job.job_id = city.job_id JOIN salary ON job.job_id = salary.job_id WHERE area.area = "ai" AND city.city_name = "texas" AND salary.money >= 65000 AND salary.time = "year"
are there any jobs requiring a bscs for boeing in seattle ?	SELECT DISTINCT job.job_id FROM job JOIN city ON job.job_id = city.job_id WHERE job.req_deg = "BSCS" AND job.company = "Boeing" AND city.city_name = "seattle"
what jobs on pc are for programming assembly and desire 5 years experience ?	SELECT DISTINCT job.job_id FROM job JOIN language ON job.job_id = language.job_id JOIN platform ON job.job_id = platform.job_id WHERE platform.platform = "pc" AND language.language = "assembly" AND job.des_exp = 5
what jobs on pc are for programming assembly and desire 5 years experience ?	SELECT DISTINCT job.job_id FROM job JOIN language ON job.job_id = language.job_id JOIN platform ON job.job_id = platform.job_id WHERE platform.platform = "pc" AND language.language = "assembly" AND job.des_exp = 5
show me jobs using lisp that require a bscs and desire a msee ?	SELECT DISTINCT job.job_id FROM job JOIN language ON job.job_id = language.job_id WHERE language.language = "lisp" AND job.req_deg = "BSCS" AND job.des_deg = "MSEE"
what programmer positions in austin require no experience ?	SELECT DISTINCT job.job_id FROM job JOIN city ON job.job_id = city.job_id WHERE job.title = "Programmer" AND city.city_name = "austin" AND job.req_exp is NULL
show me the senior development engineer jobs which require a master ?	SELECT DISTINCT job.job_id FROM job WHERE job.title = "Senior Development Engineer" AND job.req_deg = "master"
what are the jobs for a 'c++' programmer in austin ?	SELECT DISTINCT job.job_id FROM job JOIN city ON job.job_id = city.job_id JOIN language ON job.job_id = language.job_id WHERE language.language = "c++" AND job.title = "Programmer" AND city.city_name = "austin"
show me jobs located in austin for 'c++' programmers ?	SELECT DISTINCT job.job_id FROM job JOIN city ON job.job_id = city.job_id JOIN language ON job.job_id = language.job_id WHERE city.city_name = "austin" AND language.language = "c++" AND job.title = "Programmer"
are there any mac programmer jobs open in austin ?	SELECT DISTINCT job.job_id FROM job JOIN city ON job.job_id = city.job_id JOIN platform ON job.job_id = platform.job_id WHERE platform.platform = "mac" AND job.title = "Programmer" AND city.city_name = "austin"
show me jobs desiring a mscs in austin with microsoft ?	SELECT DISTINCT job.job_id FROM job JOIN city ON job.job_id = city.job_id WHERE job.des_deg = "MSCS" AND city.city_name = "austin" AND job.company = "Microsoft"
list all jobs using 'c++' and java in california ?	SELECT DISTINCT job.job_id FROM job JOIN city ON job.job_id = city.job_id JOIN language ON job.job_id = language.job_id WHERE language.language = "c++" AND language.language = "java" AND city.city_name = "california"
what jobs as manufacturing manager pay 100000 ?	SELECT DISTINCT job.job_id FROM job JOIN salary ON job.job_id = salary.job_id WHERE job.title = "Manufacturing Manager" AND salary.money >= 100000 AND salary.time = "year"
what jobs are there for 'c++' unix developer ?	SELECT DISTINCT job.job_id FROM job JOIN language ON job.job_id = language.job_id JOIN platform ON job.job_id = platform.job_id WHERE language.language = "c++" AND platform.platform = "unix" AND job.title = "Developer"
which jobs require c and 'c++' but not java ?	SELECT DISTINCT job.job_id FROM job JOIN language ON job.job_id = language.job_id WHERE language.language = "c" AND language.language = "c++" AND language.language != "java"
what web jobs are available that need mac experience and no degree ?	SELECT DISTINCT job.job_id FROM job JOIN area ON job.job_id = area.job_id JOIN platform ON job.job_id = platform.job_id WHERE area.area = "web" AND platform.platform = "mac" AND job.req_deg is NULL AND job.req_exp is not NULL
is there anything for an old cobol programmer on mvs ?	SELECT DISTINCT job.job_id FROM job JOIN language ON job.job_id = language.job_id JOIN platform ON job.job_id = platform.job_id WHERE language.language = "cobol" AND job.title = "Programmer" AND platform.platform = "mvs"
which jobs are for bsee majors with at least 5 years experience in windows nt ?	SELECT DISTINCT job.job_id FROM job JOIN platform ON job.job_id = platform.job_id WHERE job.req_deg = "BSEE" AND job.req_exp = 5 AND platform.platform = "windows nt"
which jobs are for bsee majors with at least 5 years experience in windows nt ?	SELECT DISTINCT job.job_id FROM job JOIN platform ON job.job_id = platform.job_id WHERE job.req_deg = "BSEE" AND job.req_exp = 5 AND platform.platform = "windows nt"
what jobs are there which require java on windows and unix ?	SELECT DISTINCT job.job_id FROM job JOIN language ON job.job_id = language.job_id JOIN platform ON job.job_id = platform.job_id WHERE language.language = "java" AND platform.platform = "windows" AND platform.platform = "unix"
show me austin jobs requiring a bscs degree with a salary greater than 50000 per year ?	SELECT DISTINCT job.job_id FROM job JOIN city ON job.job_id = city.job_id JOIN salary ON job.job_id = salary.job_id WHERE city.city_name = "austin" AND job.req_deg = "BSCS" AND salary.money >= 50000 AND salary.time = "year"
what ibm jobs require using java on commodores ?	SELECT DISTINCT job.job_id FROM job JOIN language ON job.job_id = language.job_id JOIN platform ON job.job_id = platform.job_id WHERE job.company = "IBM" AND language.language = "java" AND platform.platform = "commodores"
i sure would like a perl job at microsoft involving databases ?	SELECT DISTINCT job.job_id FROM job JOIN area ON job.job_id = area.job_id JOIN language ON job.job_id = language.job_id WHERE language.language = "perl" AND job.company = "Microsoft" AND area.area = "database"
what ibm jobs require using java on commodores ?	SELECT DISTINCT job.job_id FROM job JOIN language ON job.job_id = language.job_id JOIN platform ON job.job_id = platform.job_id WHERE job.company = "IBM" AND language.language = "java" AND platform.platform = "commodores"
show me jobs in austin using solaris that do not require a bscs ?	SELECT DISTINCT job.job_id FROM job JOIN city ON job.job_id = city.job_id JOIN platform ON job.job_id = platform.job_id WHERE city.city_name = "austin" AND platform.platform = "solaris" AND job.req_deg != "BSCS"
show me jobs in austin using solaris that do not require a bscs ?	SELECT DISTINCT job.job_id FROM job JOIN city ON job.job_id = city.job_id JOIN platform ON job.job_id = platform.job_id WHERE city.city_name = "austin" AND platform.platform = "solaris" AND job.req_deg != "BSCS"
who might offer me 50000 for web development ?	SELECT DISTINCT job.job_id FROM job JOIN area ON job.job_id = area.job_id JOIN salary ON job.job_id = salary.job_id WHERE salary.money >= 50000 AND salary.time = "year" AND area.area = "web" AND job.title = "Developer"
show me whats out there for perl developers on windows ?	SELECT DISTINCT job.job_id FROM job JOIN language ON job.job_id = language.job_id JOIN platform ON job.job_id = platform.job_id WHERE language.language = "perl" AND job.title = "Developer" AND platform.platform = "windows"
are there any jobs at dell that require no experience and pay 50000 ?	SELECT DISTINCT job.job_id FROM job JOIN salary ON job.job_id = salary.job_id WHERE job.company = "Dell" AND job.req_exp is NULL AND salary.money >= 50000 AND salary.time = "year"
what jobs use 'c++' on mac and pay 70000 ?	SELECT DISTINCT job.job_id FROM job JOIN language ON job.job_id = language.job_id JOIN platform ON job.job_id = platform.job_id JOIN salary ON job.job_id = salary.job_id WHERE language.language = "c++" AND platform.platform = "mac" AND salary.money >= 70000 AND salary.time = "year"
which jobs in houston offer over 50000 in graphics ?	SELECT DISTINCT job.job_id FROM job JOIN area ON job.job_id = area.job_id JOIN city ON job.job_id = city.job_id JOIN salary ON job.job_id = salary.job_id WHERE city.city_name = "houston" AND salary.money >= 50000 AND salary.time = "year" AND area.area = "graphics"
which jobs in houston offer over 50000 in graphics ?	SELECT DISTINCT job.job_id FROM job JOIN area ON job.job_id = area.job_id JOIN city ON job.job_id = city.job_id JOIN salary ON job.job_id = salary.job_id WHERE city.city_name = "houston" AND salary.money >= 50000 AND salary.time = "year" AND area.area = "graphics"
show me jobs in dallas requiring knowledge of linux and pays more than 50000 a year ?	SELECT DISTINCT job.job_id FROM job JOIN city ON job.job_id = city.job_id JOIN platform ON job.job_id = platform.job_id JOIN salary ON job.job_id = salary.job_id WHERE city.city_name = "dallas" AND platform.platform = "linux" AND salary.money >= 50000 AND salary.time = "year"
show me the jobs concerning game developer on a playstation ?	SELECT DISTINCT job.job_id FROM job JOIN area ON job.job_id = area.job_id JOIN platform ON job.job_id = platform.job_id WHERE area.area = "games" AND job.title = "Developer" AND platform.platform = "playstation"
what jobs use cobol on ibm machines and pay 70000 ?	SELECT DISTINCT job.job_id FROM job JOIN language ON job.job_id = language.job_id JOIN platform ON job.job_id = platform.job_id JOIN salary ON job.job_id = salary.job_id WHERE language.language = "cobol" AND platform.platform = "ibm" AND salary.money >= 70000 AND salary.time = "year"
show me the networking jobs in houston with a salary of 50000 ?	SELECT DISTINCT job.job_id FROM job JOIN area ON job.job_id = area.job_id JOIN city ON job.job_id = city.job_id JOIN salary ON job.job_id = salary.job_id WHERE area.area = "networking" AND city.city_name = "houston" AND salary.money >= 50000 AND salary.time = "year"
what jobs are there for 'c++' programmers which pay more than 60000 per year ?	SELECT DISTINCT job.job_id FROM job JOIN language ON job.job_id = language.job_id JOIN salary ON job.job_id = salary.job_id WHERE language.language = "c++" AND job.title = "Programmer" AND salary.money >= 60000 AND salary.time = "year"
what jobs are there working for microsoft programming lisp for autocad ?	SELECT DISTINCT job.job_id FROM job JOIN application ON job.job_id = application.job_id JOIN language ON job.job_id = language.job_id WHERE job.company = "Microsoft" AND language.language = "lisp" AND application.application = "autocad"
show me houston jobs using c in the specialty area of oil pipeline modeling ?	SELECT DISTINCT job.job_id FROM job JOIN area ON job.job_id = area.job_id JOIN city ON job.job_id = city.job_id JOIN language ON job.job_id = language.job_id WHERE city.city_name = "houston" AND language.language = "c" AND area.area = "oil pipeline modeling"
show me houston jobs using c in the specialty area of oil pipeline modeling ?	SELECT DISTINCT job.job_id FROM job JOIN area ON job.job_id = area.job_id JOIN city ON job.job_id = city.job_id JOIN language ON job.job_id = language.job_id WHERE city.city_name = "houston" AND language.language = "c" AND area.area = "oil pipeline modeling"
what jobs are there working for microsoft programming lisp for autocad ?	SELECT DISTINCT job.job_id FROM job JOIN application ON job.job_id = application.job_id JOIN language ON job.job_id = language.job_id WHERE job.company = "Microsoft" AND language.language = "lisp" AND application.application = "autocad"
what jobs in california require java and internet experience ?	SELECT DISTINCT job.job_id FROM job JOIN area ON job.job_id = area.job_id JOIN city ON job.job_id = city.job_id JOIN language ON job.job_id = language.job_id WHERE city.city_name = "california" AND language.language = "java" AND area.area = "internet" AND job.req_exp is not NULL
show jobs that do not require a degree for visual basic programmers ?	SELECT DISTINCT job.job_id FROM job JOIN language ON job.job_id = language.job_id WHERE job.req_deg is NULL AND language.language = "visual basic" AND job.title = "Programmer"
show me jobs in computer graphics requiring a ba in art and knowledge of 'speedy3dgraphics' ?	SELECT DISTINCT job.job_id FROM job JOIN application ON job.job_id = application.job_id JOIN area ON job.job_id = area.job_id WHERE area.area = "graphics" AND job.req_deg = "BA" AND application.application = "speedy3dgraphics"
what jobs desire 2 years of experience with powerbuilder on windows nt ?	SELECT DISTINCT job.job_id FROM job JOIN language ON job.job_id = language.job_id JOIN platform ON job.job_id = platform.job_id WHERE job.des_exp = 2 AND language.language = "powerbuilder" AND platform.platform = "windows nt"
show me jobs in computer graphics requiring a ba in art and knowledge of 'speedy3dgraphics' ?	SELECT DISTINCT job.job_id FROM job JOIN application ON job.job_id = application.job_id JOIN area ON job.job_id = area.job_id WHERE area.area = "graphics" AND job.req_deg = "BA" AND application.application = "speedy3dgraphics"
what jobs desire 2 years of experience with powerbuilder on windows nt ?	SELECT DISTINCT job.job_id FROM job JOIN language ON job.job_id = language.job_id JOIN platform ON job.job_id = platform.job_id WHERE job.des_exp = 2 AND language.language = "powerbuilder" AND platform.platform = "windows nt"
show the jobs offering 40000 working with c on windows nt ?	SELECT DISTINCT job.job_id FROM job JOIN language ON job.job_id = language.job_id JOIN platform ON job.job_id = platform.job_id JOIN salary ON job.job_id = salary.job_id WHERE salary.money >= 40000 AND salary.time = "year" AND language.language = "c" AND platform.platform = "windows nt"
show the jobs offering 40000 working with c on windows nt ?	SELECT DISTINCT job.job_id FROM job JOIN language ON job.job_id = language.job_id JOIN platform ON job.job_id = platform.job_id JOIN salary ON job.job_id = salary.job_id WHERE salary.money >= 40000 AND salary.time = "year" AND language.language = "c" AND platform.platform = "windows nt"
what jobs require experience in 'c++' and java but not perl ?	SELECT DISTINCT job.job_id FROM job JOIN language ON job.job_id = language.job_id WHERE language.language = "c++" AND language.language = "java" AND language.language != "perl" AND job.req_exp is not NULL
what austin area web jobs require java and 'c++' ?	SELECT DISTINCT job.job_id FROM job JOIN area ON job.job_id = area.job_id JOIN city ON job.job_id = city.job_id JOIN language ON job.job_id = language.job_id WHERE city.city_name = "austin" AND area.area = "web" AND language.language = "java" AND language.language = "c++"
what jobs require 10 years of experience require a phd are in cobol and are located in texas ?	SELECT DISTINCT job.job_id FROM job JOIN city ON job.job_id = city.job_id JOIN language ON job.job_id = language.job_id WHERE job.req_exp = 10 AND job.req_deg = "PhD" AND language.language = "cobol" AND city.city_name = "texas"
what jobs require 10 years of experience require a phd in cs are in cobol and are located in texas ?	SELECT DISTINCT job.job_id FROM job JOIN city ON job.job_id = city.job_id JOIN language ON job.job_id = language.job_id WHERE job.req_exp = 10 AND job.req_deg = "PhD" AND language.language = "cobol" AND city.city_name = "texas"
show all intern positions in texas with network and java ?	SELECT DISTINCT job.job_id FROM job JOIN area ON job.job_id = area.job_id JOIN city ON job.job_id = city.job_id JOIN language ON job.job_id = language.job_id WHERE job.title = "intern" AND city.city_name = "texas" AND area.area = "network" AND language.language = "java"
moving to canada need a job with unix java and ibm ?	SELECT DISTINCT job.job_id FROM job JOIN country ON job.job_id = country.job_id JOIN language ON job.job_id = language.job_id JOIN platform ON job.job_id = platform.job_id WHERE country.country = "canada" AND platform.platform = "unix" AND language.language = "java" AND platform.platform = "ibm"
what developer jobs in austin require a bscs and 'c++' ?	SELECT DISTINCT job.job_id FROM job JOIN city ON job.job_id = city.job_id JOIN language ON job.job_id = language.job_id WHERE job.title = "Developer" AND city.city_name = "austin" AND job.req_deg = "BSCS" AND language.language = "c++"
show me jobs in tulsa using fortran on vax requiring a bscs ?	SELECT DISTINCT job.job_id FROM job JOIN city ON job.job_id = city.job_id JOIN language ON job.job_id = language.job_id JOIN platform ON job.job_id = platform.job_id WHERE city.city_name = "tulsa" AND language.language = "fortran" AND platform.platform = "vax" AND job.req_deg = "BSCS"
are there any jobs in austin developing games in x86 using assembly ?	SELECT DISTINCT job.job_id FROM job JOIN area ON job.job_id = area.job_id JOIN city ON job.job_id = city.job_id JOIN language ON job.job_id = language.job_id JOIN platform ON job.job_id = platform.job_id WHERE city.city_name = "austin" AND area.area = "games" AND platform.platform = "x86" AND language.language = "assembly"
show me jobs in tulsa using fortran on vax requiring a bscs ?	SELECT DISTINCT job.job_id FROM job JOIN city ON job.job_id = city.job_id JOIN language ON job.job_id = language.job_id JOIN platform ON job.job_id = platform.job_id WHERE city.city_name = "tulsa" AND language.language = "fortran" AND platform.platform = "vax" AND job.req_deg = "BSCS"
what jobs are available that require java but not internet experience or ai experience ?	SELECT DISTINCT job.job_id FROM job JOIN language ON job.job_id = language.job_id WHERE language.language = "java" AND job.job_id NOT IN (SELECT DISTINCT job.job_id FROM job JOIN area ON job.job_id = area.job_id WHERE (area.area = "internet" AND job.req_exp is not NULL) OR (area.area = "ai" AND job.req_exp is not NULL))
what jobs are there for austin mac programmer using 'c++' ?	SELECT DISTINCT job.job_id FROM job JOIN city ON job.job_id = city.job_id JOIN language ON job.job_id = language.job_id JOIN platform ON job.job_id = platform.job_id WHERE city.city_name = "austin" AND platform.platform = "mac" AND job.title = "Programmer" AND language.language = "c++"
show me the jobs using perl with lockheed martin aeronautics in colorado ?	SELECT DISTINCT job.job_id FROM job JOIN city ON job.job_id = city.job_id JOIN language ON job.job_id = language.job_id WHERE language.language = "perl" AND job.company = "Lockheed Martin Aeronautics" AND city.city_name = "colorado"
show me the jobs using perl with lockheed martin aeronautics in colorado ?	SELECT DISTINCT job.job_id FROM job JOIN city ON job.job_id = city.job_id JOIN language ON job.job_id = language.job_id WHERE language.language = "perl" AND job.company = "Lockheed Martin Aeronautics" AND city.city_name = "colorado"
i wonder what jpl does on unix with prolog and vax ?	SELECT DISTINCT job.job_id FROM job JOIN language ON job.job_id = language.job_id JOIN platform ON job.job_id = platform.job_id WHERE job.company = "JPL" AND platform.platform = "unix" AND language.language = "prolog" AND platform.platform = "vax"
what jobs in dallas require a bscs and 'c++' but not java ?	SELECT DISTINCT job.job_id FROM job JOIN city ON job.job_id = city.job_id JOIN language ON job.job_id = language.job_id WHERE city.city_name = "dallas" AND job.req_deg = "BSCS" AND language.language = "c++" AND language.language != "java"
mvs cobol and databases are the key to tivoli ?	SELECT DISTINCT job.job_id FROM job JOIN area ON job.job_id = area.job_id JOIN language ON job.job_id = language.job_id JOIN platform ON job.job_id = platform.job_id WHERE platform.platform = "mvs" AND language.language = "cobol" AND area.area = "database" AND job.company = "Tivoli"
what oracle jobs are there with compaq in houston using pc ?	SELECT DISTINCT job.job_id FROM job JOIN application ON job.job_id = application.job_id JOIN city ON job.job_id = city.job_id JOIN platform ON job.job_id = platform.job_id WHERE application.application = "oracle" AND job.company = "Compaq" AND city.city_name = "houston" AND platform.platform = "pc"
which jobs offer me 40000 to work on internet and web with perl ?	SELECT DISTINCT job.job_id FROM job JOIN area ON job.job_id = area.job_id JOIN language ON job.job_id = language.job_id JOIN salary ON job.job_id = salary.job_id WHERE salary.money >= 40000 AND salary.time = "year" AND area.area = "internet" AND area.area = "web" AND language.language = "perl"
what jobs as a senior software developer are available in houston but not san antonio ?	SELECT DISTINCT job.job_id FROM job JOIN city ON job.job_id = city.job_id WHERE job.title = "Senior Software Developer" AND city.city_name = "houston" AND city.city_name != "san antonio"
what jobs require a bscs 4 years of experience pay 50000 and are in san jose ?	SELECT DISTINCT job.job_id FROM job JOIN city ON job.job_id = city.job_id JOIN salary ON job.job_id = salary.job_id WHERE job.req_deg = "BSCS" AND job.req_exp = 4 AND salary.money >= 50000 AND salary.time = "year" AND city.city_name = "san jose"
what jobs require a bscs 4 years of experience pay 50000 and are in san jose ?	SELECT DISTINCT job.job_id FROM job JOIN city ON job.job_id = city.job_id JOIN salary ON job.job_id = salary.job_id WHERE job.req_deg = "BSCS" AND job.req_exp = 4 AND salary.money >= 50000 AND salary.time = "year" AND city.city_name = "san jose"
what jobs using java and perl are available in dallas and pay 50000 a year ?	SELECT DISTINCT job.job_id FROM job JOIN city ON job.job_id = city.job_id JOIN language ON job.job_id = language.job_id JOIN salary ON job.job_id = salary.job_id WHERE language.language = "java" AND language.language = "perl" AND city.city_name = "dallas" AND salary.money >= 50000 AND salary.time = "year"
show me management jobs in boston requiring an mba and the knowledge of visual basic ?	SELECT DISTINCT job.job_id FROM job JOIN area ON job.job_id = area.job_id JOIN city ON job.job_id = city.job_id JOIN language ON job.job_id = language.job_id WHERE area.area = "management" AND city.city_name = "boston" AND job.req_deg = "MBA" AND language.language = "visual basic"
show me management jobs in boston requiring an mba and the knowledge of visual basic ?	SELECT DISTINCT job.job_id FROM job JOIN area ON job.job_id = area.job_id JOIN city ON job.job_id = city.job_id JOIN language ON job.job_id = language.job_id WHERE area.area = "management" AND city.city_name = "boston" AND job.req_deg = "MBA" AND language.language = "visual basic"
what jobs in california pay 60000 for sql development ?	SELECT DISTINCT job.job_id FROM job JOIN city ON job.job_id = city.job_id JOIN language ON job.job_id = language.job_id JOIN salary ON job.job_id = salary.job_id WHERE city.city_name = "california" AND salary.money >= 60000 AND salary.time = "year" AND language.language = "sql" AND job.title = "Developer"
what jobs in san jose offer a java programmer for 40000 a year ?	SELECT DISTINCT job.job_id FROM job JOIN city ON job.job_id = city.job_id JOIN language ON job.job_id = language.job_id JOIN salary ON job.job_id = salary.job_id WHERE city.city_name = "san jose" AND language.language = "java" AND job.title = "Programmer" AND salary.money >= 40000 AND salary.time = "year"
what engineer positions in telecommunications companies in dallas do not require 'c++' ?	SELECT DISTINCT job.job_id FROM job JOIN area ON job.job_id = area.job_id JOIN city ON job.job_id = city.job_id JOIN language ON job.job_id = language.job_id WHERE job.title = "engineer" AND area.area = "telecommunications" AND city.city_name = "dallas" AND language.language != "c++"
are there jobs using vb in seattle with sql server and on windows nt ?	SELECT DISTINCT job.job_id FROM job JOIN application ON job.job_id = application.job_id JOIN city ON job.job_id = city.job_id JOIN language ON job.job_id = language.job_id JOIN platform ON job.job_id = platform.job_id WHERE language.language = "vb" AND city.city_name = "seattle" AND application.application = "sql server" AND platform.platform = "windows nt"
which system administrator jobs in dallas require 2 years experience and pay 50000 ?	SELECT DISTINCT job.job_id FROM job JOIN city ON job.job_id = city.job_id JOIN salary ON job.job_id = salary.job_id WHERE job.title = "System Administrator" AND city.city_name = "dallas" AND job.req_exp = 2 AND salary.money >= 50000 AND salary.time = "year"
which system administrator jobs in dallas require 2 years experience and pay 50000 ?	SELECT DISTINCT job.job_id FROM job JOIN city ON job.job_id = city.job_id JOIN salary ON job.job_id = salary.job_id WHERE job.title = "System Administrator" AND city.city_name = "dallas" AND job.req_exp = 2 AND salary.money >= 50000 AND salary.time = "year"
is ibm hiring c programmers who know unix in austin	SELECT DISTINCT job.job_id FROM job JOIN city ON job.job_id = city.job_id JOIN language ON job.job_id = language.job_id JOIN platform ON job.job_id = platform.job_id WHERE job.company = "IBM" AND language.language = "c" AND job.title = "Programmer" AND platform.platform = "unix" AND city.city_name = "austin"
test engineer in need of 40000 in seattle on windows nt ?	SELECT DISTINCT job.job_id FROM job JOIN city ON job.job_id = city.job_id JOIN platform ON job.job_id = platform.job_id JOIN salary ON job.job_id = salary.job_id WHERE job.title = "Test Engineer" AND salary.money >= 40000 AND salary.time = "year" AND city.city_name = "seattle" AND platform.platform = "windows nt"
what jobs in austin are for a lisp programmer that involve unix and the internet ?	SELECT DISTINCT job.job_id FROM job JOIN area ON job.job_id = area.job_id JOIN city ON job.job_id = city.job_id JOIN language ON job.job_id = language.job_id JOIN platform ON job.job_id = platform.job_id WHERE city.city_name = "austin" AND language.language = "lisp" AND job.title = "Programmer" AND platform.platform = "unix" AND area.area = "internet"
what jobs give me 40000 to work in houston on internet and web with perl ?	SELECT DISTINCT job.job_id FROM job JOIN area ON job.job_id = area.job_id JOIN city ON job.job_id = city.job_id JOIN language ON job.job_id = language.job_id JOIN salary ON job.job_id = salary.job_id WHERE salary.money >= 40000 AND salary.time = "year" AND city.city_name = "houston" AND area.area = "internet" AND area.area = "web" AND language.language = "perl"
what jobs are there in austin for project manager area games on mac using pascal ?	SELECT DISTINCT job.job_id FROM job JOIN area ON job.job_id = area.job_id JOIN city ON job.job_id = city.job_id JOIN language ON job.job_id = language.job_id JOIN platform ON job.job_id = platform.job_id WHERE city.city_name = "austin" AND job.title = "Project Manager" AND area.area = "games" AND platform.platform = "mac" AND language.language = "pascal"
whats in dallas that pays over 60000 on linux with graphics and java ?	SELECT DISTINCT job.job_id FROM job JOIN area ON job.job_id = area.job_id JOIN city ON job.job_id = city.job_id JOIN language ON job.job_id = language.job_id JOIN platform ON job.job_id = platform.job_id JOIN salary ON job.job_id = salary.job_id WHERE city.city_name = "dallas" AND salary.money >= 60000 AND salary.time = "year" AND platform.platform = "linux" AND area.area = "graphics" AND language.language = "java"
show me jobs in austin that use java on unix for a developer paying at least 50000 ?	SELECT DISTINCT job.job_id FROM job JOIN city ON job.job_id = city.job_id JOIN language ON job.job_id = language.job_id JOIN platform ON job.job_id = platform.job_id JOIN salary ON job.job_id = salary.job_id WHERE city.city_name = "austin" AND language.language = "java" AND platform.platform = "unix" AND job.title = "Developer" AND salary.money >= 50000 AND salary.time = "year"
vanity wants 5000 a month with buzwords like java apple internet and california ?	SELECT DISTINCT job.job_id FROM job JOIN area ON job.job_id = area.job_id JOIN city ON job.job_id = city.job_id JOIN language ON job.job_id = language.job_id JOIN salary ON job.job_id = salary.job_id WHERE salary.money >= 5000 AND salary.time = "month" AND language.language = "java" AND job.company = "Apple" AND area.area = "internet" AND city.city_name = "california"
if i moved to california and learned sql on oracle could i find anything for 30000 on unix ?	SELECT DISTINCT job.job_id FROM job JOIN application ON job.job_id = application.job_id JOIN city ON job.job_id = city.job_id JOIN language ON job.job_id = language.job_id JOIN platform ON job.job_id = platform.job_id JOIN salary ON job.job_id = salary.job_id WHERE city.city_name = "california" AND language.language = "sql" AND application.application = "oracle" AND salary.money >= 30000 AND salary.time = "year" AND platform.platform = "unix"
greed for 80000 and java plagues developer wanting to live in san jose at apple ?	SELECT DISTINCT job.job_id FROM job JOIN city ON job.job_id = city.job_id JOIN language ON job.job_id = language.job_id JOIN salary ON job.job_id = salary.job_id WHERE salary.money >= 80000 AND salary.time = "year" AND language.language = "java" AND job.title = "Software Developer" AND city.city_name = "san jose" AND job.company = "Apple"
only microsoft vb windows nt and excel and 70000 dollars can satiate me ?	SELECT DISTINCT job.job_id FROM job JOIN application ON job.job_id = application.job_id JOIN language ON job.job_id = language.job_id JOIN platform ON job.job_id = platform.job_id JOIN salary ON job.job_id = salary.job_id WHERE job.company = "Microsoft" AND language.language = "vb" AND platform.platform = "windows nt" AND application.application = "excel" AND salary.money >= 70000 AND salary.time = "year"
