whats all there ?	answer(job(all))
show me all job that are available	answer(job(all))
all ?	answer(job(all))
all of it ?	answer(job(all))
all the jobs please ?	answer(job(all))
show me all job that are available	answer(job(all))
give me a list of all the jobs ?	answer(job(all))
show me what jobs there are ?	answer(job(all))
show me everything ?	answer(job(all))
everything ?	answer(job(all))
could you list all the jobs ?	answer(job(all))
what work do you have available ?	answer(job(all))
what are all the jobs ?	answer(job(all))
id like to see everything ?	answer(job(all))
what jobs are there ?	answer(job(all))
i would like to see all the jobs ?	answer(job(all))
show me what needs experience ?	answer(req_exp(job(all)))
show me jobs requiring no experience	answer(not(req_exp(job(all))))
show me jobs requiring no experience	answer(not(req_exp(job(all))))
show jobs in usa ?	answer(job(loc_1(const(usa))))
what jobs are there for a com specialist ?	answer(job(area_1(const(com))))
show the jobs for a com specialist ?	answer(job(area_1(const(com))))
list jobs in wan ?	answer(job(area_1(const(wan))))
what jobs are there for a gui specialist ?	answer(job(area_1(const(gui))))
show me positions in web programming ?	answer(job(area_1(const(web))))
are there any jobs in lan ?	answer(job(area_1(const(lan))))
give me the jobs for a lan specialist ?	answer(job(area_1(const(lan))))
show me the jobs that require 2 years experience	answer(job(req_exp_1(const(2))))
what jobs need at least 2 years of experience ?	answer(job(req_exp_1(const(2))))
show me jobs in texas	answer(job(loc_1(const(texas))))
show me the jobs that require 2 years experience	answer(job(req_exp_1(const(2))))
show the jobs for a odbc specialist ?	answer(job(area_1(const(odbc))))
are there any jobs requiring bs ?	answer(job(req_deg_1(const(BS))))
are there any jobs requiring ba ?	answer(job(req_deg_1(const(BA))))
give me the jobs in dallas ?	answer(job(loc_1(const(dallas))))
give me the jobs for a games specialist ?	answer(job(area_1(const(games))))
what jobs are there in games ?	answer(job(area_1(const(games))))
give me jobs in dallas ?	answer(job(loc_1(const(dallas))))
are there any jobs in austin ?	answer(job(loc_1(const(austin))))
show the jobs in austin ?	answer(job(loc_1(const(austin))))
list jobs in austin ?	answer(job(loc_1(const(austin))))
show the jobs in dallas ?	answer(job(loc_1(const(dallas))))
list the jobs requiring bs ?	answer(job(req_deg_1(const(BS))))
tell me the jobs requiring bs ?	answer(job(req_deg_1(const(BS))))
show jobs requiring ba ?	answer(job(req_deg_1(const(BA))))
list jobs in austin ?	answer(job(loc_1(const(austin))))
list jobs requiring ba ?	answer(job(req_deg_1(const(BA))))
what jobs are there requiring ba ?	answer(job(req_deg_1(const(BA))))
give me jobs for a games specialist ?	answer(job(area_1(const(games))))
give me jobs requiring bs ?	answer(job(req_deg_1(const(BS))))
are there any jobs requiring bs ?	answer(job(req_deg_1(const(BS))))
what jobs are there requiring bs ?	answer(job(req_deg_1(const(BS))))
are there any jobs requiring ba ?	answer(job(req_deg_1(const(BA))))
show the jobs requiring ba ?	answer(job(req_deg_1(const(BA))))
give me jobs requiring bs ?	answer(job(req_deg_1(const(BS))))
what jobs are there in houston ?	answer(job(loc_1(const(houston))))
are there any jobs in houston ?	answer(job(loc_1(const(houston))))
what jobs are there in usa ?	answer(job(country_1(const(usa))))
tell me the jobs on mvs ?	answer(job(platform_1(const(mvs))))
show me the jobs that operate on sun ?	answer(job(platform_1(const(sun))))
what jobs are there requiring bscs ?	answer(job(req_deg_1(const(BSCS))))
list jobs on sun ?	answer(job(platform_1(const(sun))))
list the jobs in 'c++' ?	answer(job(language_1(const(c++))))
are there any jobs requiring bsee ?	answer(job(req_deg_1(const(BSEE))))
are there any jobs requiring bsee ?	answer(job(req_deg_1(const(BSEE))))
list jobs requiring bsee ?	answer(job(req_deg_1(const(BSEE))))
show jobs requiring bsee ?	answer(job(req_deg_1(const(BSEE))))
are there any jobs on sun ?	answer(job(platform_1(const(sun))))
are there any jobs using sql ?	answer(job(language_1(const(sql))))
are there any jobs on ibm ?	answer(job(platform_1(const(ibm))))
are there any jobs requiring bscs ?	answer(job(req_deg_1(const(BSCS))))
what jobs are there on x86 ?	answer(job(platform_1(const(x86))))
show the jobs on sun ?	answer(job(platform_1(const(sun))))
are there any jobs on vax ?	answer(job(platform_1(const(vax))))
what jobs are there requiring bsee ?	answer(job(req_deg_1(const(BSEE))))
what jobs are there using rpg ?	answer(job(language_1(const(rpg))))
give me the jobs requiring bsee ?	answer(job(req_deg_1(const(BSEE))))
what jobs are there on x86 ?	answer(job(platform_1(const(x86))))
what jobs are there on aix ?	answer(job(platform_1(const(aix))))
list jobs using sql ?	answer(job(language_1(const(sql))))
show the jobs requiring bsee ?	answer(job(req_deg_1(const(BSEE))))
show the jobs on mvs ?	answer(job(platform_1(const(mvs))))
show the jobs on vms ?	answer(job(platform_1(const(vms))))
i want a job that use 'c++' ?	answer(job(language_1(const(c++))))
what jobs require a bscs ?	answer(job(req_deg_1(const(BSCS))))
what jobs are there on vms ?	answer(job(platform_1(const(vms))))
give me the jobs using sql ?	answer(job(language_1(const(sql))))
what jobs are there using sql ?	answer(job(language_1(const(sql))))
are there any jobs requiring bscs ?	answer(job(req_deg_1(const(BSCS))))
any jobs available using database ?	answer(job(area_1(const(database))))
show jobs using cics ?	answer(job(language_1(const(cics))))
what jobs does lcs recruit for ?	answer(job(recruiter_1(const(LCS))))
show jobs in html ?	answer(job(language_1(const(html))))
what database jobs are there ?	answer(job(area_1(const(database))))
are there any mac jobs open ?	answer(job(platform_1(const(mac))))
give me the jobs on unix ?	answer(job(platform_1(const(unix))))
are there any jobs for a graphics specialist ?	answer(job(area_1(const(graphics))))
what jobs are there using cics ?	answer(job(language_1(const(cics))))
are there any unix jobs ?	answer(job(platform_1(const(unix))))
show the jobs using html ?	answer(job(language_1(const(html))))
i would like to find a job using java ?	answer(job(language_1(const(java))))
list the jobs on unix ?	answer(job(platform_1(const(unix))))
what jobs are there for a database specialist ?	answer(job(area_1(const(database))))
any jobs available using database ?	answer(job(area_1(const(database))))
tell me jobs using html ?	answer(job(language_1(const(html))))
list the jobs in database ?	answer(job(area_1(const(database))))
list the jobs using cics ?	answer(job(language_1(const(cics))))
list the jobs for a database specialist ?	answer(job(area_1(const(database))))
are there any jobs that require the knowledge of linux platform ?	answer(job(platform_1(const(linux))))
what jobs can i find with tivoli ?	answer(job(company_1(const(Tivoli))))
what jobs are there using cobol ?	answer(job(language_1(const(cobol))))
are there any jobs using cobol ?	answer(job(language_1(const(cobol))))
what positions are there in networking ?	answer(job(area_1(const(networking))))
what jobs are there for a networking specialist ?	answer(job(area_1(const(networking))))
tell me jobs in networking ?	answer(job(area_1(const(networking))))
what jobs are there using 'tcl/tk' ?	answer(job(language_1(const(tcl/tk))))
are there any computer jobs in the field of statistics ?	answer(job(area_1(const(statistics))))
are there any jobs on novell ?	answer(job(platform_1(const(novell))))
are there any jobs for a programmer ?	answer(job(title_1(const(Programmer))))
are there any programmer jobs open ?	answer(job(title_1(const(Programmer))))
what jobs have a salary greater than 20 and hour ?	answer(job(salary_greater_than(20,hour)))
are there any programmer jobs open ?	answer(job(title_1(const(Programmer))))
is fortran required for any jobs ?	answer(job(language_1(const(fortran))))
are there any jobs on windows ?	answer(job(platform_1(const(windows))))
show jobs on windows ?	answer(job(platform_1(const(windows))))
give me jobs in san antonio ?	answer(job(loc_1(const('san antonio'))))
list jobs using assembly ?	answer(job(language_1(const(assembly))))
list the positions that require a knowledge of microsoft excel ?	answer(job(application_1(const(excel))))
list the positions that require a knowledge of microsoft excel ?	answer(job(application_1(const(excel))))
are there any jobs in san antonio ?	answer(job(loc_1(const('san antonio'))))
list the jobs using assembly ?	answer(job(language_1(const(assembly))))
show the jobs in san antonio ?	answer(job(loc_1(const('san antonio'))))
are there any jobs in san antonio ?	answer(job(loc_1(const('san antonio'))))
tell me the jobs in '3d' graphics ?	answer(job(area_1(const('3d graphics'))))
show me something that requires oracle ?	answer(job(application_1(const(oracle))))
what jobs are there for a '3d' graphics specialist ?	answer(job(area_1(const('3d graphics'))))
are there any jobs for a client server specialist ?	answer(job(area_1(const(client/server))))
what jobs are there for a '3d' graphics specialist ?	answer(job(area_1(const('3d graphics'))))
show the jobs in client server ?	answer(job(area_1(const(client/server))))
what jobs does microsoft recruit for ?	answer(job(company_1(const(Microsoft))))
list the jobs for a client server specialist ?	answer(job(area_1(const(client/server))))
what jobs are longhorn employment hiring for ?	answer(job(recruiter_1(const(Longhorn))))
show me jobs not involving 'c++' ?	answer(job(not(language_1(const(c++)))))
show me jobs not involving 'c++' ?	answer(job(not(language_1(const(c++)))))
list jobs in client server ?	answer(job(area_1(const(client/server))))
what jobs are longhorn employment hiring for ?	answer(job(recruiter_1(const(Longhorn))))
what are the jobs that pay 50000 per year ?	answer(job(salary_greater_than(50000,year)))
what jobs are there with a salary of 40000 ?	answer(job(salary_greater_than(40000,year)))
are there any autocad jobs open ?	answer(job(application_1(const(autocad))))
list the jobs using cobol ii ?	answer(job(language_1(const('cobol ii'))))
what jobs are there with a salary of more than 50000 dollars per year ?	answer(job(salary_greater_than(50000,year)))
show me jobs with a salary greater than 50000 dollars a year ?	answer(job(salary_greater_than(50000,year)))
show me the jobs with 30000 salary	answer(job(salary_greater_than(30000,year)))
list jobs in cobol ii ?	answer(job(language_1(const('cobol ii'))))
what jobs are there with a salary of 40000 ?	answer(job(salary_greater_than(40000,year)))
what jobs pay 40000 ?	answer(job(salary_greater_than(40000,year)))
give me jobs in cobol ii ?	answer(job(language_1(const('cobol ii'))))
show me the jobs with 30000 salary	answer(job(salary_greater_than(30000,year)))
are there any autocad jobs open ?	answer(job(application_1(const(autocad))))
tell me jobs using cobol ii ?	answer(job(language_1(const('cobol ii'))))
show me jobs paying greater than 50000 per year ?	answer(job(salary_greater_than(50000,year)))
what jobs pay at least 80000 dollars per year ?	answer(job(salary_greater_than(80000,year)))
tell me jobs for a device driver specialist ?	answer(job(area_1(const('device driver'))))
are there any jobs with a salary of 100000 ?	answer(job(salary_greater_than(100000,year)))
list the jobs in visual 'c++' ?	answer(job(language_1(const('visual c++'))))
tell me the jobs using powerbuilder ?	answer(job(language_1(const(powerbuilder))))
give me jobs using visual 'c++' ?	answer(job(language_1(const('visual c++'))))
which jobs use visual 'j++' as their development tool ?	answer(job(language_1(const('visual j++'))))
which jobs use visual 'j++' as their development tool ?	answer(job(language_1(const('visual j++'))))
what jobs are there on windows 95 ?	answer(job(platform_1(const('windows 95'))))
show the jobs in visual 'c++' ?	answer(job(language_1(const('visual c++'))))
give me the jobs in visual 'c++' ?	answer(job(language_1(const('visual c++'))))
are there any jobs using powerbuilder ?	answer(job(language_1(const(powerbuilder))))
tell me the jobs on windows nt ?	answer(job(platform_1(const('windows nt'))))
what jobs are there on windows nt ?	answer(job(platform_1(const('windows nt'))))
show jobs using powerbuilder ?	answer(job(language_1(const(powerbuilder))))
show me the jobs that are not in haskell ?	answer(job(not(language_1(const(haskell)))))
i want a job that doesnt use windows ?	answer(job(not(platform_1(const(windows)))))
show me the jobs that are not in haskell ?	answer(job(not(language_1(const(haskell)))))
what jobs have a recruiter named phil smith ?	answer(job(recruiter_1(const('Phil Smith'))))
are there any jobs for a data warehousing specialist ?	answer(job(area_1(const('data warehousing'))))
what jobs in austin require no experience ?	answer(job(not(req_exp(loc_1(const(austin))))))
tell me the jobs using visual basic ?	answer(job(language_1(const('visual basic'))))
what jobs are there in data warehousing ?	answer(job(area_1(const('data warehousing'))))
are there any project manager positions open ?	answer(job(title_1(const('Project Manager'))))
show jobs for a data warehousing specialist ?	answer(job(area_1(const('data warehousing'))))
give me jobs for a data warehousing specialist ?	answer(job(area_1(const('data warehousing'))))
tell me jobs using visual basic ?	answer(job(language_1(const('visual basic'))))
show jobs using visual basic ?	answer(job(language_1(const('visual basic'))))
what jobs in austin require no experience ?	answer(job(not(req_exp(loc_1(const(austin))))))
are there any project manager positions open ?	answer(job(title_1(const('Project Manager'))))
are there jobs that do not require a degree in houston ?	answer(job(not(req_deg(loc_1(const(houston))))))
what jobs require a bscs and no experience ?	answer(job(not(req_exp(req_deg_1(const(BSCS))))))
show me the job application for ic design engineer ?	answer(job(title_1(const('Ic Design Engineer'))))
what jobs are there that dont require a degree but use perl ?	answer(job(not(req_deg(language_1(const(perl))))))
what jobs use html but do not require a degree ?	answer(job(not(req_deg(language_1(const(html))))))
list the required experience for a job using lisp ?	answer(req_exp_0(job(language_1(const(lisp)))))
where can i work with a bscs and no experience ?	answer(loc_0(intersect(req_deg_1(const(BSCS)),not(req_exp(job(all))))))
list the companies that desire 'c++' experience ?	answer(company_0(intersect(language_1(const(c++)),des_exp(job(all)))))
are there any jobs in the us with the title verification engineer ?	answer(job(title_1(const('Verification Engineer'))))
what jobs desire a degree but dont use 'c++'	answer(job(des_deg(not(language_1(const(c++))))))
what jobs desire a degree but dont use 'c++'	answer(job(des_deg(not(language_1(const(c++))))))
how much experience is wanted for a job at microsoft ?	answer(req_exp_0(job(company_1(const(Microsoft)))))
show the jobs for bscs in austin ?	answer(intersect(req_deg_1(const(BSCS)),loc_1(const(austin))))
what are the degree requirements for a software engineer ?	answer(req_deg_0(title_1(const('Software Engineer'))))
tell me the jobs requiring bs in usa ?	answer(job(intersect(req_deg_1(const(BS)),loc_1(const(usa)))))
can i find a job making more than 40000 a year without a degree ?	answer(job(not(req_deg(salary_greater_than(40000,year)))))
are there any jobs specializing in ai with jpl ?	answer(job(intersect(area_1(const(ai)),company_1(const(JPL)))))
show me the jobs that require 1 year of experience but desire 2 years of experiences	answer(job(intersect(req_exp_1(const(1)),des_exp_1(const(2)))))
are there any jobs specializing in ai with jpl ?	answer(job(intersect(area_1(const(ai)),company_1(const(JPL)))))
what jobs do not require a degree but pay more than 60000 ?	answer(job(not(req_deg(salary_greater_than(60000,year)))))
what jobs are there in usa on ibm ?	answer(job(intersect(loc_1(const(usa)),platform_1(const(ibm)))))
what ai positions require only a bscs ?	answer(job(intersect(area_1(const(ai)),req_deg_1(const(BSCS)))))
what jobs in austin require 10 years of experience ?	answer(job(intersect(loc_1(const(austin)),req_exp_1(const(10)))))
what jobs are there in austin that require 5 years experience ?	answer(job(intersect(loc_1(const(austin)),req_exp_1(const(5)))))
give me the jobs for a database specialist in usa ?	answer(job(intersect(area_1(const(database)),loc_1(const(usa)))))
what project manager jobs are there that require experience ?	answer(job(req_exp(title_1(const('Project Manager')))))
show the jobs requiring bs in usa ?	answer(job(intersect(req_deg_1(const(BS)),country_1(const(usa)))))
what job is there for a bscs with 5 years of experience ?	answer(job(intersect(req_deg_1(const(BSCS)),req_exp_1(const(5)))))
give some jobs in dallas on a sun system ?	answer(job(intersect(loc_1(const(dallas)),platform_1(const(sun)))))
show jobs in austin that require a bscs ?	answer(job(intersect(loc_1(const(austin)),req_deg_1(const(BSCS)))))
what jobs are there in dallas that requires a mscs ?	answer(job(intersect(loc_1(const(dallas)),req_deg_1(const(MSCS)))))
whats available on vax and near austin ?	answer(job(intersect(platform_1(const(vax)),loc_1(const(austin)))))
show me the jobs at companies in austin that want a degree in bscs	answer(job(intersect(loc_1(const(austin)),des_deg_1(const(BSCS)))))
find all network administration jobs in austin ?	answer(job(intersect(area_1(const(network)),loc_1(const(austin)))))
show me austin jobs requiring a bscs ?	answer(job(intersect(loc_1(const(austin)),req_deg_1(const(BSCS)))))
what 'c++' jobs are in austin ?	answer(job(intersect(language_1(const(c++)),loc_1(const(austin)))))
show me austin jobs desiring a bscs	answer(job(intersect(loc_1(const(austin)),des_deg_1(const(BSCS)))))
what jobs require at least 1 year of experience in 'c++' ?	answer(job(intersect(req_exp_1(const(1)),language_1(const(c++)))))
show jobs in austin that require a bscs ?	answer(job(intersect(loc_1(const(austin)),req_deg_1(const(BSCS)))))
what jobs in boston have openings for a 'c++' programmer ?	answer(job(intersect(loc_1(const(boston)),language_1(const(c++)))))
find all network administration jobs in austin ?	answer(job(intersect(area_1(const(network)),loc_1(const(austin)))))
what jobs in boston have openings for a 'c++' programmer ?	answer(job(intersect(loc_1(const(boston)),language_1(const(c++)))))
show me the jobs at companies in austin that want a degree in bscs	answer(job(intersect(loc_1(const(austin)),des_deg_1(const(BSCS)))))
find all 'c++' jobs in austin ?	answer(job(intersect(language_1(const(c++)),loc_1(const(austin)))))
what 'c++' jobs are in austin ?	answer(job(intersect(language_1(const(c++)),loc_1(const(austin)))))
i hold a degree in bscs in austin are there any jobs for me ?	answer(job(intersect(des_deg_1(const(BSCS)),loc_1(const(austin)))))
i wish there were some perl jobs in boston ?	answer(job(intersect(language_1(const(perl)),loc_1(const(boston)))))
show me the jobs requiring 3 years of experience at tivoli ?	answer(job(intersect(req_exp_1(const(3)),company_1(const(Tivoli)))))
what jobs in austin require knowledge of the platform unix ?	answer(job(intersect(loc_1(const(austin)),platform_1(const(unix)))))
what jobs in austin need knowledge in unix ?	answer(job(intersect(loc_1(const(austin)),platform_1(const(unix)))))
what are the jobs in washington that require at least 5 years of experience ?	answer(job(intersect(loc_1(const(washington)),req_exp_1(const(5)))))
show me dallas jobs requiring a bscs ?	answer(job(intersect(loc_1(const(dallas)),req_deg_1(const(BSCS)))))
list the jobs using html for a games specialist ?	answer(job(intersect(language_1(const(html)),area_1(const(games)))))
what jobs in houston require a bacs ?	answer(job(intersect(loc_1(const(houston)),req_deg_1(const(BACS)))))
show the jobs on pc requiring bscs ?	answer(job(intersect(platform_1(const(pc)),req_deg_1(const(BSCS)))))
what jobs are there in austin that require a bscs degree ?	answer(job(intersect(loc_1(const(austin)),req_deg_1(const(BSCS)))))
do you have any jobs involving 'c++' on aix ?	answer(job(intersect(language_1(const(c++)),platform_1(const(aix)))))
are there any jobs using 'c++' with dell ?	answer(job(intersect(language_1(const(c++)),company_1(const(Dell)))))
tell me the jobs requiring ba using cobol ?	answer(job(intersect(req_deg_1(const(BA)),language_1(const(cobol)))))
what jobs require a bscs degree and desire an mscs degree ?	answer(job(intersect(req_deg_1(const(BSCS)),des_deg_1(const(MSCS)))))
what jobs at dell require a bscs ?	answer(job(intersect(company_1(const(Dell)),req_deg_1(const(BSCS)))))
what are the jobs that require experience with microsoft word ?	answer(job(req_exp(application_1(const('microsoft word')))))
are there any jobs using assembly in usa ?	answer(job(intersect(language_1(const(assembly)),loc_1(const(usa)))))
what are the jobs that require experience with microsoft word ?	answer(job(req_exp(application_1(const('microsoft word')))))
are there any jobs using 'c++' with dell ?	answer(job(intersect(language_1(const(c++)),company_1(const(Dell)))))
give me jobs on vms using sql ?	answer(job(intersect(platform_1(const(vms)),language_1(const(sql)))))
show me jobs at dell requiring a bscs degree ?	answer(job(intersect(company_1(const(Dell)),req_deg_1(const(BSCS)))))
show me jobs requiring a bscs on sun ?	answer(job(intersect(req_deg_1(const(BSCS)),platform_1(const(sun)))))
show me jobs requiring a bscs on suns ?	answer(job(intersect(req_deg_1(const(BSCS)),platform_1(const(sun)))))
show the jobs with the title systems programmer requiring 2 years of experience	answer(job(intersect(title_1(const(Programmer)),req_exp_1(const(2)))))
show me programmer jobs in tulsa ?	answer(job(intersect(title_1(const(Programmer)),loc_1(const(tulsa)))))
show me the jobs using lisp requiring a bscs ?	answer(job(intersect(language_1(const(lisp)),req_deg_1(const(BSCS)))))
give me jobs on the mac using perl ?	answer(job(intersect(platform_1(const(mac)),language_1(const(perl)))))
list jobs requiring bscs using java ?	answer(job(intersect(req_deg_1(const(BSCS)),language_1(const(java)))))
show me programmer jobs in tulsa ?	answer(job(intersect(title_1(const(Programmer)),loc_1(const(tulsa)))))
what positions are there that use 'c++' and java ?	answer(job(intersect(language_1(const(c++)),language_1(const(java)))))
show me the jobs using lisp requiring a bscs ?	answer(job(intersect(language_1(const(lisp)),req_deg_1(const(BSCS)))))
show me new york jobs requiring a bscs ?	answer(job(intersect(loc_1(const('new york')),req_deg_1(const(BSCS)))))
is anyone offering 40000 for ai work ?	answer(job(intersect(salary_greater_than(40000,year),area_1(const(ai)))))
which jobs at trilogy deal with 'c++' ?	answer(job(intersect(company_1(const(Trilogy)),language_1(const(c++)))))
show jobs for a shell programmer familiar with the unix environment ?	answer(job(intersect(language_1(const(shell)),platform_1(const(unix)))))
what tivoli jobs are there that require a bscs degree ?	answer(job(intersect(company_1(const(Tivoli)),req_deg_1(const(BSCS)))))
what jobs using fortran are there in houston ?	answer(job(intersect(language_1(const(fortran)),loc_1(const(houston)))))
which jobs at trilogy deal with 'c++' ?	answer(job(intersect(company_1(const(Trilogy)),language_1(const(c++)))))
what are the jobs in austin requiring knowledge of oracle ?	answer(job(intersect(loc_1(const(austin)),application_1(const(oracle)))))
show the companies that are looking for bscs in austin	answer(company_0(intersect(req_deg_1(const(BSCS)),loc_1(const(austin)))))
are there any mac programmer jobs ?	answer(job(intersect(platform_1(const(mac)),title_1(const(Programmer)))))
does national instruments have any positions that dont require experience ?	answer(job(not(req_exp(company_1(const('National Instruments'))))))
are there any mac programmer jobs ?	answer(job(intersect(platform_1(const(mac)),title_1(const(Programmer)))))
does national instruments have any positions that dont require experience ?	answer(job(not(req_exp(company_1(const('National Instruments'))))))
what jobs are there in austin for people with knowledge of the application oracle ?	answer(job(intersect(loc_1(const(austin)),application_1(const(oracle)))))
show me austin jobs with a salary of 50000	answer(job(intersect(loc_1(const(austin)),salary_greater_than(50000,year))))
what jobs in austin have a salary of 60000 ?	answer(job(intersect(loc_1(const(austin)),salary_greater_than(60000,year))))
what jobs are there for assembly programmer that require a bscs ?	answer(job(intersect(language_1(const(assembly)),req_deg_1(const(BSCS)))))
what jobs in austin have a salary of 60000 ?	answer(job(intersect(loc_1(const(austin)),salary_greater_than(60000,year))))
what are the positions within hp that pay 40000 per year ?	answer(job(intersect(company_1(const(HP)),salary_greater_than(40000,year))))
what are the positions within hp that pay 40000 per year ?	answer(job(intersect(company_1(const(HP)),salary_greater_than(40000,year))))
show me austin jobs with a salary of 50000	answer(job(intersect(loc_1(const(austin)),salary_greater_than(50000,year))))
what jobs are there in austin with a salary of at least 100000 per year ?	answer(job(intersect(loc_1(const(austin)),salary_greater_than(100000,year))))
are there any jobs using java that are not with ibm ?	answer(job(intersect(language_1(const(java)),not(company_1(const(IBM))))))
what jobs are there for programmers who know java ?	answer(job(intersect(title_1(const(Programmer)),language_1(const(java)))))
i sure do wish there were java assembly jobs out there '.' can you help ?	answer(job(intersect(language_1(const(java)),language_1(const(assembly)))))
could i have some jobs using sql with oracle ?	answer(job(intersect(language_1(const(sql)),application_1(const(oracle)))))
show me the jobs concerning games development on a playstation ?	answer(job(intersect(area_1(const(games)),platform_1(const(playstation)))))
what jobs need knowledge of 'c++' or java ?	answer(job(or(language_1(const(c++)),language_1(const(java)))))
are there any jobs in 'c++' that the salary is 50000 ?	answer(job(intersect(language_1(const(c++)),salary_greater_than(50000,year))))
what jobs pay 40000 per year that require a bscs ?	answer(job(intersect(salary_greater_than(40000,year),req_deg_1(const(BSCS)))))
are there any jobs using java that dont require a bscs ?	answer(job(intersect(language_1(const(java)),not(req_deg_1(const(BSCS))))))
give me jobs in san antonio using cobol ?	answer(job(intersect(loc_1(const('san antonio')),language_1(const(cobol)))))
what web developer jobs are there in austin ?	answer(job(intersect(title_1(const('Web Developer')),loc_1(const(austin)))))
are there any jobs that require a knowledge of linux in san antonio ?	answer(job(intersect(platform_1(const(linux)),loc_1(const('san antonio')))))
show me jobs at dell earning 60000	answer(job(intersect(company_1(const(Dell)),salary_greater_than(60000,year))))
show the jobs using lisp not requiring a bscs	answer(job(intersect(language_1(const(lisp)),not(req_deg_1(const(BSCS))))))
are there any jobs in austin paying over 100000 per year ?	answer(job(intersect(loc_1(const(austin)),salary_greater_than(100000,year))))
what are the jobs using 'c++' with salaries of 50000 ?	answer(job(intersect(language_1(const(c++)),salary_greater_than(50000,year))))
what jobs in san antonio require the use of cobol ?	answer(job(intersect(loc_1(const('san antonio')),language_1(const(cobol)))))
what jobs require knowledge of 'c++' but not perl ?	answer(job(intersect(language_1(const(c++)),not(language_1(const(perl))))))
what jobs require knowledge of 'c++' but not perl ?	answer(job(intersect(language_1(const(c++)),not(language_1(const(perl))))))
can you offer anything with at least 60000 on a sun ?	answer(job(intersect(salary_greater_than(60000,year),platform_1(const(sun)))))
show the jobs using lisp not requiring a degree in cs ?	answer(job(intersect(language_1(const(lisp)),not(req_deg_1(const(BSCS))))))
what do you have paying over 40000 on the vax ?	answer(job(intersect(salary_greater_than(40000,year),platform_1(const(vax)))))
what jobs pay 40000 per year that desire a bscs ?	answer(job(intersect(salary_greater_than(40000,year),des_deg_1(const(BSCS)))))
show me the jobs using java with salaries greater than 50000	answer(job(intersect(language_1(const(java)),salary_greater_than(50000,year))))
what jobs using fortran are there in los alamos ?	answer(job(intersect(language_1(const(fortran)),loc_1(const('los alamos')))))
what jobs require 'c++' and pays a salary greater than 90000 per year ?	answer(job(intersect(language_1(const(c++)),salary_greater_than(90000,year))))
show the jobs with the title systems analyst requiring 2 years of experience ?	answer(job(intersect(title_1(const('Systems Analyst')),req_exp_1(const(2)))))
what jobs are there for web developer who know 'c++' ?	answer(job(intersect(title_1(const('Web Developer')),language_1(const(c++)))))
what jobs are there for pascal programers who dont know 'c++'	answer(job(intersect(language_1(const(pascal)),not(language_1(const(c++))))))
what jobs are there outside austin which pay less than 60000 per year ?	answer(job(intersect(not(loc_1(const(austin))),salary_less_than(60000,year))))
what jobs are available using apache with a specialty area of networking ?	answer(job(intersect(application_1(const(apache)),area_1(const(networking)))))
what jobs are there for web developer who know 'c++' ?	answer(job(intersect(title_1(const('Web Developer')),language_1(const(c++)))))
what systems analyst jobs are there in austin ?	answer(job(intersect(title_1(const('Systems Analyst')),loc_1(const(austin)))))
give me 'c++' jobs on windows nt ?	answer(job(intersect(platform_1(const('windows nt')),language_1(const(c++)))))
what jobs are available using apache with a specialty area of networking ?	answer(job(intersect(application_1(const(apache)),area_1(const(networking)))))
are there any jobs using java that are not with tivoli ?	answer(job(intersect(language_1(const(java)),not(company_1(const(Tivoli))))))
what jobs in dallas require experience with unix ?	answer(job(req_exp(intersect(loc_1(const(dallas)),platform_1(const(unix))))))
what jobs are there for a test engineer using java ?	answer(job(intersect(title_1(const('Test Engineer')),language_1(const(java)))))
give me the jobs using 'c++' that dont require windows ?	answer(job(intersect(language_1(const(c++)),not(platform_1(const(windows))))))
show me systems analyst jobs at ibm ?	answer(job(intersect(title_1(const('Systems Analyst')),company_1(const(IBM)))))
what jobs are there for programmers that know assembly ?	answer(job(intersect(title_1(const(Programmer)),language_1(const(assembly)))))
what jobs are there in austin that requires experience with unix ?	answer(job(req_exp(intersect(loc_1(const(austin)),platform_1(const(unix))))))
what locations offer jobs using java on sun ?	answer(loc_0(job(intersect(language_1(const(java)),platform_1(const(sun))))))
what jobs are in seattle that are not at microsoft ?	answer(job(intersect(loc_1(const(seattle)),not(company_1(const(Microsoft))))))
what web related jobs require a bscs but no experience ?	answer(job(not(req_exp(intersect(area_1(const(web)),req_deg_1(const(BSCS)))))))
show me jobs with the playstation in the specialty area of animation ?	answer(job(intersect(platform_1(const(playstation)),area_1(const(animation)))))
what microsoft jobs do not require a bscs ?	answer(job(intersect(company_1(const(Microsoft)),not(req_deg_1(const(BSCS))))))
show me all of the software engineer jobs in austin ?	answer(job(intersect(title_1(const('Software Engineer')),loc_1(const(austin)))))
show me graphics jobs which phil smith is recruiting for ?	answer(job(intersect(area_1(const(graphics)),recruiter_1(const('Phil Smith')))))
who gives 50000 for fortran ?	answer(job(intersect(salary_greater_than(50000,year),language_1(const(fortran)))))
what jobs in austin only require a bscs and no experience ?	answer(job(not(req_exp(intersect(loc_1(const(austin)),req_deg_1(const(BSCS)))))))
what jobs are there in texas that use java and require no experience ?	answer(job(not(req_exp(intersect(loc_1(const(texas)),language_1(const(java)))))))
show me graphics jobs which phil smith is recruiting for ?	answer(job(intersect(area_1(const(graphics)),recruiter_1(const('Phil Smith')))))
what jobs are there in texas that use java and require no experience ?	answer(job(not(req_exp(intersect(loc_1(const(texas)),language_1(const(java)))))))
what microsoft jobs do not require a bscs ?	answer(job(intersect(company_1(const(Microsoft)),not(req_deg_1(const(BSCS))))))
what jobs are available for someone who knows oracle on solaris ?	answer(job(intersect(platform_1(const(solaris)),application_1(const(oracle)))))
which jobs pay 60000 that do not require a phd ?	answer(job(intersect(salary_greater_than(60000,year),not(req_deg_1(const(PhD))))))
are there any software developer jobs requiring bs ?	answer(job(intersect(title_1(const('Software Developer')),req_deg_1(const(BS)))))
show me jobs are dell requiring experience on unix ?	answer(job(req_exp(intersect(company_1(const(Dell)),platform_1(const(unix))))))
show me the research assistant job in austin	answer(job(intersect(title_1(const('research assistant')),loc_1(const(austin)))))
show me the research assistant job in austin	answer(job(intersect(title_1(const('research assistant')),loc_1(const(austin)))))
show me jobs for dell requiring experience on unix ?	answer(job(req_exp(intersect(company_1(const(Dell)),platform_1(const(unix))))))
show me web developer job openings at trilogy ?	answer(job(intersect(title_1(const('Web Developer')),company_1(const(Trilogy)))))
what jobs in ibm in austin do not need a degree ?	answer(job(intersect(company_1(const(IBM)),loc_1(const(austin)),not(req_deg(job(all))))))
are there any jobs for people in austin that want to program in lisp but do not have a degree ?	answer(job(not(req_deg(intersect(loc_1(const(austin)),language_1(const(lisp)))))))
are there any jobs for people in austin that want to program in lisp but do not have a degree ?	answer(job(not(req_deg(intersect(loc_1(const(austin)),language_1(const(lisp)))))))
what are the software engineering jobs available using ada ?	answer(job(intersect(language_1(const(ada)),title_1(const('Software Engineer')))))
show me jobs at dell requiring no experience and a bscs ?	answer(job(not(req_exp(intersect(company_1(const(Dell)),req_deg_1(const(BSCS)))))))
what software engineer jobs are there that use 'c++' ?	answer(job(intersect(title_1(const('Software Engineer')),language_1(const(c++)))))
show me systems analyst jobs at tivoli ?	answer(job(intersect(title_1(const('Systems Analyst')),company_1(const(Tivoli)))))
what austin jobs that use cobol do not require any experience ?	answer(job(not(req_exp(intersect(loc_1(const(austin)),language_1(const(cobol)))))))
show me jobs at dell requiring no experience and a bscs ?	answer(job(not(req_exp(intersect(company_1(const(Dell)),req_deg_1(const(BSCS)))))))
what are the software engineer jobs available using ada ?	answer(job(intersect(title_1(const('Software Engineer')),language_1(const(ada)))))
does apple have any software engineer positions ?	answer(job(intersect(company_1(const(Apple)),title_1(const('Software Engineer')))))
what jobs are there for a visual basic developer ?	answer(job(intersect(language_1(const('visual basic')),title_1(const(Developer)))))
show me developer jobs requiring experience with mac ?	answer(job(req_exp(intersect(title_1(const(Developer)),platform_1(const(mac))))))
which jobs in austin offer for students fresh out of college in networking ?	answer(job(not(req_exp(intersect(loc_1(const(austin)),area_1(const(networking)))))))
which jobs in austin offer for students fresh out of college in networking ?	answer(job(not(req_exp(intersect(loc_1(const(austin)),area_1(const(networking)))))))
what programmer positions in austin require no experience ?	answer(job(not(req_exp(intersect(title_1(const(Programmer)),loc_1(const(austin)))))))
what job is there for 'c++' but not visual 'c++' ?	answer(job(intersect(language_1(const(c++)),not(language_1(const('visual c++'))))))
are there any systems administrator jobs in austin ?	answer(job(intersect(title_1(const('Systems Administrator')),loc_1(const(austin)))))
what system administrator jobs are available from dell ?	answer(job(intersect(title_1(const('System Administrator')),company_1(const(Dell)))))
what jobs pay 60000 are located in austin and require a degree ?	answer(job(req_deg(intersect(salary_greater_than(60000,year),loc_1(const(austin))))))
what jobs are there doing computer graphics on silicon graphics machines ?	answer(job(intersect(area_1(const(graphics)),platform_1(const('silicon graphics')))))
what jobs as an sql engineer pay 100000 ?	answer(job(intersect(title_1(const('Sql Engineer')),salary_greater_than(100000,year))))
what system administrator jobs are available from dell ?	answer(job(intersect(title_1(const('System Administrator')),company_1(const(Dell)))))
what programming languages are desired for a job as a programmer at ibm ?	answer(language_0(job(intersect(title_1(const(Programmer)),company_1(const(IBM))))))
what jobs require a bscs and experience with oracle ?	answer(job(req_exp(intersect(req_deg_1(const(BSCS)),application_1(const(oracle))))))
show a list of jobs requiring experience in 'c++' or java ?	answer(job(req_exp(or(language_1(const(c++)),language_1(const(java))))))
give me jobs that require ethernet experience but no html ?	answer(job(req_exp(intersect(area_1(const(ethernet)),not(language_1(const(html)))))))
what jobs in austin require 5 years of experience but desire 10 years of experience ?	answer(job(intersect(loc_1(const(austin)),req_exp_1(const(5)),des_exp_1(const(10)))))
show me the jobs in texas using ai on unix ?	answer(job(intersect(loc_1(const(texas)),area_1(const(ai)),platform_1(const(unix)))))
what jobs require a degree for pascal programmers who do not know 'c++' ?	answer(job(req_deg(intersect(language_1(const(pascal)),not(language_1(const(c++)))))))
could a senior consulting engineer find work in boston ?	answer(job(intersect(title_1(const('Senior Consulting Engineer')),loc_1(const(boston)))))
show me the jobs in texas using ai on unix ?	answer(job(intersect(loc_1(const(texas)),area_1(const(ai)),platform_1(const(unix)))))
are there any jobs at dell that require no experience and pay 50000 ?	answer(job(not(req_exp(intersect(company_1(const(Dell)),salary_greater_than(50000,year))))))
what jobs in austin require 5 years of experience but desire 10 years of experience ?	answer(job(intersect(loc_1(const(austin)),req_exp_1(const(5)),des_exp_1(const(10)))))
what web jobs are available that need mac experience and no degree ?	answer(job(req_exp(not(req_deg(intersect(area_1(const(web)),platform_1(const(mac))))))))
show me the jobs in austin that desire 3 years of experience and use 'c++' ?	answer(job(intersect(loc_1(const(austin)),des_exp_1(const(3)),language_1(const(c++)))))
show me the jobs in austin that desire 3 years of experience and use 'c++' ?	answer(job(intersect(loc_1(const(austin)),des_exp_1(const(3)),language_1(const(c++)))))
show me programmer jobs requiring no experience on unix ?	answer(job(intersect(title_1(const(Programmer)),not(req_exp(platform_1(const(unix)))))))
show me the hardware platforms associated with a netware administrator with ibm ?	answer(platform_0(intersect(title_1(const('NetWare Administrator')),company_1(const(IBM)))))
show me the senior software developer jobs which require a master ?	answer(job(intersect(title_1(const('Senior Software Developer')),req_deg_1(const(master)))))
what jobs in houston are there that requires a bscs with 1 year of experience ?	answer(job(intersect(loc_1(const(houston)),req_deg_1(const(BSCS)),req_exp_1(const(1)))))
what jobs use 'c++' with the web on macs ?	answer(job(intersect(language_1(const(c++)),area_1(const(web)),platform_1(const(mac)))))
show me 'c++' jobs requiring a bscs in austin ?	answer(job(intersect(language_1(const(c++)),req_deg_1(const(BSCS)),loc_1(const(austin)))))
what are the 'c++' jobs in austin requiring a bscs ?	answer(job(intersect(language_1(const(c++)),loc_1(const(austin)),req_deg_1(const(BSCS)))))
show me houston jobs using 'c++' on pc ?	answer(job(intersect(loc_1(const(houston)),language_1(const(c++)),platform_1(const(pc)))))
what java jobs are there with ibm in austin ?	answer(job(intersect(language_1(const(java)),company_1(const(IBM)),loc_1(const(austin)))))
what jobs in austin require a bscs degree and deal with 'tcp/ip' ?	answer(job(intersect(loc_1(const(austin)),req_deg_1(const(BSCS)),area_1(const(tcp/ip)))))
show me the 'c++' jobs in nashville that desire 2 years experience	answer(job(intersect(language_1(const(c++)),loc_1(const(nashville)),des_exp_1(const(2)))))
what jobs as manufacturing manager pay 100000 ?	answer(job(intersect(title_1(const('Manufacturing Manager')),salary_greater_than(100000,year))))
show me a dell job in austin requiring a bscs ?	answer(job(intersect(company_1(const(Dell)),loc_1(const(austin)),req_deg_1(const(BSCS)))))
what are the 'c++' jobs in austin requiring a bscs ?	answer(job(intersect(language_1(const(c++)),loc_1(const(austin)),req_deg_1(const(BSCS)))))
show me 'c++' jobs requiring a bscs in austin ?	answer(job(intersect(language_1(const(c++)),req_deg_1(const(BSCS)),loc_1(const(austin)))))
list the jobs requiring java a bscs 2 years experience	answer(job(intersect(language_1(const(java)),req_deg_1(const(BSCS)),req_exp_1(const(2)))))
show me the senior development engineer jobs which require a master ?	answer(job(intersect(title_1(const('Senior Development Engineer')),req_deg_1(const(master)))))
show me a dell job in austin requiring a bscs ?	answer(job(intersect(company_1(const(Dell)),loc_1(const(austin)),req_deg_1(const(BSCS)))))
what jobs in austin desiring a bscs are there for a 'c++' programmer ?	answer(job(intersect(loc_1(const(austin)),des_deg_1(const(BSCS)),language_1(const(c++)))))
what ai jobs are there in texas that pay 65000 ?	answer(job(intersect(area_1(const(ai)),loc_1(const(texas)),salary_greater_than(65000,year))))
show me a job that requires 'c++' and java and is in austin ?	answer(job(intersect(language_1(const(c++)),language_1(const(java)),loc_1(const(austin)))))
what jobs in austin use 'c++' and java ?	answer(job(intersect(loc_1(const(austin)),language_1(const(c++)),language_1(const(java)))))
are there any jobs in austin requiring at least a bscs and knowing latex ?	answer(job(intersect(loc_1(const(austin)),req_deg_1(const(BSCS)),language_1(const(latex)))))
show me the jobs using 'c++' that require a bscs but desire a mscs ?	answer(job(intersect(language_1(const(c++)),req_deg_1(const(BSCS)),des_deg_1(const(MSCS)))))
show me the jobs using 'c++' that require a bscs but desire a mscs ?	answer(job(intersect(language_1(const(c++)),req_deg_1(const(BSCS)),des_deg_1(const(MSCS)))))
are there any jobs requiring a bscs for boeing in seattle ?	answer(job(intersect(req_deg_1(const(BSCS)),company_1(const(Boeing)),loc_1(const(seattle)))))
what jobs on pc are for programming assembly and desire 5 years experience ?	answer(job(intersect(platform_1(const(pc)),language_1(const(assembly)),des_exp_1(const(5)))))
what jobs on pc are for programming assembly and desire 5 years experience ?	answer(job(intersect(platform_1(const(pc)),language_1(const(assembly)),des_exp_1(const(5)))))
show jobs that do not require a degree for visual basic programmers ?	answer(job(not(req_deg(intersect(language_1(const('visual basic')),title_1(const(Programmer)))))))
show me jobs using lisp that require a bscs and desire a msee ?	answer(job(intersect(language_1(const(lisp)),req_deg_1(const(BSCS)),des_deg_1(const(MSEE)))))
what are the jobs for a 'c++' programmer in austin ?	answer(job(intersect(language_1(const(c++)),title_1(const(Programmer)),loc_1(const(austin)))))
show me jobs located in austin for 'c++' programmers ?	answer(job(intersect(loc_1(const(austin)),language_1(const(c++)),title_1(const(Programmer)))))
show me jobs desiring a mscs in austin with microsoft ?	answer(job(intersect(des_deg_1(const(MSCS)),loc_1(const(austin)),company_1(const(Microsoft)))))
list all jobs using 'c++' and java in california ?	answer(job(intersect(language_1(const(c++)),language_1(const(java)),loc_1(const(california)))))
are there any mac programmer jobs open in austin ?	answer(job(intersect(platform_1(const(mac)),title_1(const(Programmer)),loc_1(const(austin)))))
what jobs are there for 'c++' unix developer ?	answer(job(intersect(language_1(const(c++)),platform_1(const(unix)),title_1(const(Developer)))))
show me austin jobs requiring a bscs degree with a salary greater than 50000 per year ?	answer(job(intersect(loc_1(const(austin)),req_deg_1(const(BSCS)),salary_greater_than(50000,year))))
which jobs require c and 'c++' but not java ?	answer(job(intersect(language_1(const(c)),language_1(const(c++)),not(language_1(const(java))))))
who might offer me 50000 for web development ?	answer(job(intersect(salary_greater_than(50000,year),area_1(const(web)),title_1(const(Developer)))))
is there anything for an old cobol programmer on mvs ?	answer(job(intersect(language_1(const(cobol)),title_1(const(Programmer)),platform_1(const(mvs)))))
which jobs are for bsee majors with at least 5 years experience in windows nt ?	answer(job(intersect(req_deg_1(const(BSEE)),req_exp_1(const(5)),platform_1(const('windows nt')))))
which jobs are for bsee majors with at least 5 years experience in windows nt ?	answer(job(intersect(req_deg_1(const(BSEE)),req_exp_1(const(5)),platform_1(const('windows nt')))))
what jobs use 'c++' on mac and pay 70000 ?	answer(job(intersect(language_1(const(c++)),platform_1(const(mac)),salary_greater_than(70000,year))))
what jobs are there which require java on windows and unix ?	answer(job(intersect(language_1(const(java)),platform_1(const(windows)),platform_1(const(unix)))))
which jobs in houston offer over 50000 in graphics ?	answer(job(intersect(loc_1(const(houston)),salary_greater_than(50000,year),area_1(const(graphics)))))
what ibm jobs require using java on commodores ?	answer(job(intersect(company_1(const(IBM)),language_1(const(java)),platform_1(const(commodores)))))
i sure would like a perl job at microsoft involving databases ?	answer(job(intersect(language_1(const(perl)),company_1(const(Microsoft)),area_1(const(database)))))
which jobs in houston offer over 50000 in graphics ?	answer(job(intersect(loc_1(const(houston)),salary_greater_than(50000,year),area_1(const(graphics)))))
what ibm jobs require using java on commodores ?	answer(job(intersect(company_1(const(IBM)),language_1(const(java)),platform_1(const(commodores)))))
show me jobs in austin using solaris that do not require a bscs ?	answer(job(intersect(loc_1(const(austin)),platform_1(const(solaris)),not(req_deg_1(const(BSCS))))))
show me jobs in austin using solaris that do not require a bscs ?	answer(job(intersect(loc_1(const(austin)),platform_1(const(solaris)),not(req_deg_1(const(BSCS))))))
show me whats out there for perl developers on windows ?	answer(job(intersect(language_1(const(perl)),title_1(const(Developer)),platform_1(const(windows)))))
show me jobs in dallas requiring knowledge of linux and pays more than 50000 a year ?	answer(job(intersect(loc_1(const(dallas)),platform_1(const(linux)),salary_greater_than(50000,year))))
what jobs use cobol on ibm machines and pay 70000 ?	answer(job(intersect(language_1(const(cobol)),platform_1(const(ibm)),salary_greater_than(70000,year))))
show me the jobs concerning game developer on a playstation ?	answer(job(intersect(area_1(const(games)),title_1(const(Developer)),platform_1(const(playstation)))))
show me the networking jobs in houston with a salary of 50000 ?	answer(job(intersect(area_1(const(networking)),loc_1(const(houston)),salary_greater_than(50000,year))))
what jobs are there for 'c++' programmers which pay more than 60000 per year ?	answer(job(intersect(language_1(const(c++)),title_1(const(Programmer)),salary_greater_than(60000,year))))
what jobs are there working for microsoft programming lisp for autocad ?	answer(job(intersect(company_1(const(Microsoft)),language_1(const(lisp)),application_1(const(autocad)))))
show me houston jobs using c in the specialty area of oil pipeline modeling ?	answer(job(intersect(loc_1(const(houston)),language_1(const(c)),area_1(const('oil pipeline modeling')))))
show me houston jobs using c in the specialty area of oil pipeline modeling ?	answer(job(intersect(loc_1(const(houston)),language_1(const(c)),area_1(const('oil pipeline modeling')))))
what jobs are there working for microsoft programming lisp for autocad ?	answer(job(intersect(company_1(const(Microsoft)),language_1(const(lisp)),application_1(const(autocad)))))
show the jobs offering 40000 working with c on windows nt ?	answer(job(intersect(salary_greater_than(40000,year),language_1(const(c)),platform_1(const('windows nt')))))
show the jobs offering 40000 working with c on windows nt ?	answer(job(intersect(salary_greater_than(40000,year),language_1(const(c)),platform_1(const('windows nt')))))
what jobs in california require java and internet experience ?	answer(job(req_exp(intersect(loc_1(const(california)),language_1(const(java)),area_1(const(internet))))))
show me jobs in computer graphics requiring a ba in art and knowledge of 'speedy3dgraphics' ?	answer(job(intersect(area_1(const(graphics)),req_deg_1(const(BA)),application_1(const(speedy3dgraphics)))))
what jobs desire 2 years of experience with powerbuilder on windows nt ?	answer(job(intersect(des_exp_1(const(2)),language_1(const(powerbuilder)),platform_1(const('windows nt')))))
show me jobs in computer graphics requiring a ba in art and knowledge of 'speedy3dgraphics' ?	answer(job(intersect(area_1(const(graphics)),req_deg_1(const(BA)),application_1(const(speedy3dgraphics)))))
what jobs desire 2 years of experience with powerbuilder on windows nt ?	answer(job(intersect(des_exp_1(const(2)),language_1(const(powerbuilder)),platform_1(const('windows nt')))))
what jobs require experience in 'c++' and java but not perl ?	answer(job(req_exp(intersect(language_1(const(c++)),language_1(const(java)),not(language_1(const(perl)))))))
what austin area web jobs require java and 'c++' ?	answer(job(intersect(loc_1(const(austin)),area_1(const(web)),language_1(const(java)),language_1(const(c++)))))
what jobs require 10 years of experience require a phd are in cobol and are located in texas ?	answer(job(intersect(req_exp_1(const(10)),req_deg_1(const(PhD)),language_1(const(cobol)),loc_1(const(texas)))))
what jobs require 10 years of experience require a phd in cs are in cobol and are located in texas ?	answer(job(intersect(req_exp_1(const(10)),req_deg_1(const(PhD)),language_1(const(cobol)),loc_1(const(texas)))))
show all intern positions in texas with network and java ?	answer(job(intersect(title_1(const(intern)),loc_1(const(texas)),area_1(const(network)),language_1(const(java)))))
show me the jobs using perl with lockheed martin aeronautics in colorado ?	answer(job(intersect(language_1(const(perl)),company_1(const('Lockheed Martin Aeronautics')),loc_1(const(colorado)))))
show me the jobs using perl with lockheed martin aeronautics in colorado ?	answer(job(intersect(language_1(const(perl)),company_1(const('Lockheed Martin Aeronautics')),loc_1(const(colorado)))))
moving to canada need a job with unix java and ibm ?	answer(job(intersect(loc_1(const(canada)),platform_1(const(unix)),language_1(const(java)),platform(const(ibm))))
what developer jobs in austin require a bscs and 'c++' ?	answer(job(intersect(title_1(const(Developer)),loc_1(const(austin)),req_deg_1(const(BSCS)),language_1(const(c++)))))
show me jobs in tulsa using fortran on vax requiring a bscs ?	answer(job(intersect(loc_1(const(tulsa)),language_1(const(fortran)),platform_1(const(vax)),req_deg_1(const(BSCS)))))
are there any jobs in austin developing games in x86 using assembly ?	answer(job(intersect(loc_1(const(austin)),area_1(const(games)),platform_1(const(x86)),language_1(const(assembly)))))
show me jobs in tulsa using fortran on vax requiring a bscs ?	answer(job(intersect(loc_1(const(tulsa)),language_1(const(fortran)),platform_1(const(vax)),req_deg_1(const(BSCS)))))
what jobs are there for austin mac programmer using 'c++' ?	answer(job(intersect(loc_1(const(austin)),platform_1(const(mac)),title_1(const(Programmer)),language_1(const(c++)))))
what jobs are available that require java but not internet experience or ai experience ?	answer(job(intersect(language_1(const(java)),not(or(req_exp(area_1(const(internet))),req_exp(area_1(const(ai))))))))
i wonder what jpl does on unix with prolog and vax ?	answer(job(intersect(company_1(const(JPL)),platform_1(const(unix)),language_1(const(prolog)),platform_1(const(vax)))))
which jobs offer me 40000 to work on internet and web with perl ?	answer(job(intersect(salary_greater_than(40000,year),area_1(const(internet)),area_1(const(web)),language_1(const(perl)))))
mvs cobol and databases are the key to tivoli ?	answer(job(intersect(platform_1(const(mvs)),language_1(const(cobol)),area_1(const(database)),company_1(const(Tivoli)))))
what jobs as a senior software developer are available in houston but not san antonio ?	answer(job(intersect(title_1(const('Senior Software Developer')),loc_1(const(houston)),not(loc_1(const('san antonio'))))))
what jobs in dallas require a bscs and 'c++' but not java ?	answer(job(intersect(loc_1(const(dallas)),req_deg_1(const(BSCS)),language_1(const(c++)),not(language_1(const(java))))))
what jobs require a bscs 4 years of experience pay 50000 and are in san jose ?	answer(job(intersect(req_deg_1(const(BSCS)),req_exp_1(const(4)),salary_greater_than(50000,year),loc_1(const('san jose')))))
what jobs require a bscs 4 years of experience pay 50000 and are in san jose ?	answer(job(intersect(req_deg_1(const(BSCS)),req_exp_1(const(4)),salary_greater_than(50000,year),loc_1(const('san jose')))))
what oracle jobs are there with compaq in houston using pc ?	answer(job(intersect(application_1(const(oracle)),company_1(const(Compaq)),loc_1(const(houston)),platform_1(const(pc)))))
what jobs using java and perl are available in dallas and pay 50000 a year ?	answer(job(intersect(language_1(const(java)),language_1(const(perl)),loc_1(const(dallas)),salary_greater_than(50000,year))))
show me management jobs in boston requiring an mba and the knowledge of visual basic ?	answer(job(intersect(area_1(const(management)),loc_1(const(boston)),req_deg_1(const(MBA)),language_1(const('visual basic')))))
show me management jobs in boston requiring an mba and the knowledge of visual basic ?	answer(job(intersect(area_1(const(management)),loc_1(const(boston)),req_deg_1(const(MBA)),language_1(const('visual basic')))))
what jobs in california pay 60000 for sql development ?	answer(job(intersect(loc_1(const(california)),salary_greater_than(60000,year),language_1(const(sql)),title_1(const(Developer)))))
what jobs in san jose offer a java programmer for 40000 a year ?	answer(job(intersect(loc_1(const('san jose')),language_1(const(java)),title_1(const(Programmer)),salary_greater_than(40000,year))))
which system administrator jobs in dallas require 2 years experience and pay 50000 ?	answer(job(intersect(title_1(const('System Administrator')),loc_1(const(dallas)),req_exp_1(const(2)),salary_greater_than(50000,year))))
what engineer positions in telecommunications companies in dallas do not require 'c++' ?	answer(job(intersect(title_1(const(engineer)),area_1(const(telecommunications)),loc_1(const(dallas)),not(language_1(const(c++))))))
which system administrator jobs in dallas require 2 years experience and pay 50000 ?	answer(job(intersect(title_1(const('System Administrator')),loc_1(const(dallas)),req_exp_1(const(2)),salary_greater_than(50000,year))))
are there jobs using vb in seattle with sql server and on windows nt ?	answer(job(intersect(language_1(const(vb)),loc_1(const(seattle)),application_1(const('sql server')),platform_1(const('windows nt')))))
test engineer in need of 40000 in seattle on windows nt ?	answer(job(intersect(title_1(const('Test Engineer')),salary_greater_than(40000,year),loc_1(const(seattle)),platform_1(const('windows nt')))))
is ibm hiring c programmers who know unix in austin	answer(job(intersect(company_1(const(IBM)),language_1(const(c)),title_1(const(Programmer)),platform_1(const(unix)),loc_1(const(austin)))))
what jobs give me 40000 to work in houston on internet and web with perl ?	answer(job(intersect(salary_greater_than(40000,year),loc_1(const(houston)),area_1(const(internet)),area_1(const(web)),language_1(const(perl)))))
what jobs in austin are for a lisp programmer that involve unix and the internet ?	answer(job(intersect(loc_1(const(austin)),language_1(const(lisp)),title_1(const(Programmer)),platform_1(const(unix)),area_1(const(internet)))))
whats in dallas that pays over 60000 on linux with graphics and java ?	answer(job(intersect(loc_1(const(dallas)),salary_greater_than(60000,year),platform_1(const(linux)),area_1(const(graphics)),language_1(const(java)))))
what jobs are there in austin for project manager area games on mac using pascal ?	answer(job(intersect(loc_1(const(austin)),title_1(const('Project Manager')),area_1(const(games)),platform_1(const(mac)),language_1(const(pascal)))))
show me jobs in austin that use java on unix for a developer paying at least 50000 ?	answer(job(intersect(loc_1(const(austin)),language_1(const(java)),platform_1(const(unix)),title_1(const(Developer)),salary_greater_than(50000,year))))
vanity wants 5000 a month with buzwords like java apple internet and california ?	answer(job(intersect(salary_greater_than(5000,month),language_1(const(java)),company_1(const(Apple)),area_1(const(internet)),loc_1(const(california)))))
if i moved to california and learned sql on oracle could i find anything for 30000 on unix ?	answer(job(intersect(loc_1(const(california)),language_1(const(sql)),application_1(const(oracle)),salary_greater_than(30000,year),platform_1(const(unix)))))
greed for 80000 and java plagues developer wanting to live in san jose at apple ?	answer(job(intersect(salary_greater_than(80000,year),language_1(const(java)),title_1(const('Software Developer')),loc_1(const('san jose')),company_1(const(Apple)))))
only microsoft vb windows nt and excel and 70000 dollars can satiate me ?	answer(job(intersect(company_1(const(Microsoft)),language_1(const(vb)),platform_1(const('windows nt')),application_1(const(excel)),salary_greater_than(70000,year))))
