whats all there ?	(lambda $0:e (job $0))
show me all job that are available	(lambda $0:e (job $0))
all ?	(lambda $0:e (job $0))
all of it ?	(lambda $0:e (job $0))
all the jobs please ?	(lambda $0:e (job $0))
show me all job that are available	(lambda $0:e (job $0))
give me a list of all the jobs ?	(lambda $0:e (job $0))
show me what jobs there are ?	(lambda $0:e (job $0))
show me everything ?	(lambda $0:e (job $0))
everything ?	(lambda $0:e (job $0))
could you list all the jobs ?	(lambda $0:e (job $0))
what work do you have available ?	(lambda $0:e (job $0))
what are all the jobs ?	(lambda $0:e (job $0))
id like to see everything ?	(lambda $0:e (job $0))
what jobs are there ?	(lambda $0:e (job $0))
i would like to see all the jobs ?	(lambda $0:e (job $0))
show me what needs experience ?	(lambda $0:e (and_ (job $0) (req_exp $0)))
show me jobs requiring no experience	(lambda $0:e (and_ (job $0) (not_ (req_exp $0))))
show me jobs requiring no experience	(lambda $0:e (and_ (job $0) (not_ (req_exp $0))))
show jobs in usa ?	(lambda $0:e (and_ (job $0) (loc $0 usa)))
what jobs are there for a com specialist ?	(lambda $0:e (and_ (job $0) (area $0 com)))
show the jobs for a com specialist ?	(lambda $0:e (and_ (job $0) (area $0 com)))
list jobs in wan ?	(lambda $0:e (and_ (job $0) (area $0 wan)))
what jobs are there for a gui specialist ?	(lambda $0:e (and_ (job $0) (area $0 gui)))
show me positions in web programming ?	(lambda $0:e (and_ (job $0) (area $0 web)))
are there any jobs in lan ?	(lambda $0:e (and_ (job $0) (area $0 lan)))
give me the jobs for a lan specialist ?	(lambda $0:e (and_ (job $0) (area $0 lan)))
show me the jobs that require 2 years experience	(lambda $0:e (and_ (job $0) (req_exp $0 2)))
what jobs need at least 2 years of experience ?	(lambda $0:e (and_ (job $0) (req_exp $0 2)))
show me jobs in texas	(lambda $0:e (and_ (job $0) (loc $0 texas)))
show me the jobs that require 2 years experience	(lambda $0:e (and_ (job $0) (req_exp $0 2)))
show the jobs for a odbc specialist ?	(lambda $0:e (and_ (job $0) (area $0 odbc)))
are there any jobs requiring bs ?	(lambda $0:e (and_ (job $0) (req_deg $0 BS)))
are there any jobs requiring ba ?	(lambda $0:e (and_ (job $0) (req_deg $0 BA)))
give me the jobs in dallas ?	(lambda $0:e (and_ (job $0) (loc $0 dallas)))
give me the jobs for a games specialist ?	(lambda $0:e (and_ (job $0) (area $0 games)))
what jobs are there in games ?	(lambda $0:e (and_ (job $0) (area $0 games)))
give me jobs in dallas ?	(lambda $0:e (and_ (job $0) (loc $0 dallas)))
are there any jobs in austin ?	(lambda $0:e (and_ (job $0) (loc $0 austin)))
show the jobs in austin ?	(lambda $0:e (and_ (job $0) (loc $0 austin)))
list jobs in austin ?	(lambda $0:e (and_ (job $0) (loc $0 austin)))
show the jobs in dallas ?	(lambda $0:e (and_ (job $0) (loc $0 dallas)))
list the jobs requiring bs ?	(lambda $0:e (and_ (job $0) (req_deg $0 BS)))
tell me the jobs requiring bs ?	(lambda $0:e (and_ (job $0) (req_deg $0 BS)))
show jobs requiring ba ?	(lambda $0:e (and_ (job $0) (req_deg $0 BA)))
list jobs in austin ?	(lambda $0:e (and_ (job $0) (loc $0 austin)))
list jobs requiring ba ?	(lambda $0:e (and_ (job $0) (req_deg $0 BA)))
what jobs are there requiring ba ?	(lambda $0:e (and_ (job $0) (req_deg $0 BA)))
give me jobs for a games specialist ?	(lambda $0:e (and_ (job $0) (area $0 games)))
give me jobs requiring bs ?	(lambda $0:e (and_ (job $0) (req_deg $0 BS)))
are there any jobs requiring bs ?	(lambda $0:e (and_ (job $0) (req_deg $0 BS)))
what jobs are there requiring bs ?	(lambda $0:e (and_ (job $0) (req_deg $0 BS)))
are there any jobs requiring ba ?	(lambda $0:e (and_ (job $0) (req_deg $0 BA)))
show the jobs requiring ba ?	(lambda $0:e (and_ (job $0) (req_deg $0 BA)))
give me jobs requiring bs ?	(lambda $0:e (and_ (job $0) (req_deg $0 BS)))
what jobs are there in houston ?	(lambda $0:e (and_ (job $0) (loc $0 houston)))
are there any jobs in houston ?	(lambda $0:e (and_ (job $0) (loc $0 houston)))
what jobs are there in usa ?	(lambda $0:e (and_ (job $0) (country $0 usa)))
tell me the jobs on mvs ?	(lambda $0:e (and_ (job $0) (platform $0 mvs)))
show me the jobs that operate on sun ?	(lambda $0:e (and_ (job $0) (platform $0 sun)))
what jobs are there requiring bscs ?	(lambda $0:e (and_ (job $0) (req_deg $0 BSCS)))
list jobs on sun ?	(lambda $0:e (and_ (job $0) (platform $0 sun)))
list the jobs in 'c++' ?	(lambda $0:e (and_ (job $0) (language $0 c++)))
are there any jobs requiring bsee ?	(lambda $0:e (and_ (job $0) (req_deg $0 BSEE)))
are there any jobs requiring bsee ?	(lambda $0:e (and_ (job $0) (req_deg $0 BSEE)))
list jobs requiring bsee ?	(lambda $0:e (and_ (job $0) (req_deg $0 BSEE)))
show jobs requiring bsee ?	(lambda $0:e (and_ (job $0) (req_deg $0 BSEE)))
are there any jobs on sun ?	(lambda $0:e (and_ (job $0) (platform $0 sun)))
are there any jobs using sql ?	(lambda $0:e (and_ (job $0) (language $0 sql)))
are there any jobs on ibm ?	(lambda $0:e (and_ (job $0) (platform $0 ibm)))
are there any jobs requiring bscs ?	(lambda $0:e (and_ (job $0) (req_deg $0 BSCS)))
what jobs are there on x86 ?	(lambda $0:e (and_ (job $0) (platform $0 x86)))
show the jobs on sun ?	(lambda $0:e (and_ (job $0) (platform $0 sun)))
are there any jobs on vax ?	(lambda $0:e (and_ (job $0) (platform $0 vax)))
what jobs are there requiring bsee ?	(lambda $0:e (and_ (job $0) (req_deg $0 BSEE)))
what jobs are there using rpg ?	(lambda $0:e (and_ (job $0) (language $0 rpg)))
give me the jobs requiring bsee ?	(lambda $0:e (and_ (job $0) (req_deg $0 BSEE)))
what jobs are there on x86 ?	(lambda $0:e (and_ (job $0) (platform $0 x86)))
what jobs are there on aix ?	(lambda $0:e (and_ (job $0) (platform $0 aix)))
list jobs using sql ?	(lambda $0:e (and_ (job $0) (language $0 sql)))
show the jobs requiring bsee ?	(lambda $0:e (and_ (job $0) (req_deg $0 BSEE)))
show the jobs on mvs ?	(lambda $0:e (and_ (job $0) (platform $0 mvs)))
show the jobs on vms ?	(lambda $0:e (and_ (job $0) (platform $0 vms)))
i want a job that use 'c++' ?	(lambda $0:e (and_ (job $0) (language $0 c++)))
what jobs require a bscs ?	(lambda $0:e (and_ (job $0) (req_deg $0 BSCS)))
what jobs are there on vms ?	(lambda $0:e (and_ (job $0) (platform $0 vms)))
give me the jobs using sql ?	(lambda $0:e (and_ (job $0) (language $0 sql)))
what jobs are there using sql ?	(lambda $0:e (and_ (job $0) (language $0 sql)))
are there any jobs requiring bscs ?	(lambda $0:e (and_ (job $0) (req_deg $0 BSCS)))
are there any mac jobs open ?	(lambda $0:e (and_ (job $0) (platform $0 mac)))
any jobs available using database ?	(lambda $0:e (and_ (job $0) (area $0 database)))
show jobs using cics ?	(lambda $0:e (and_ (job $0) (language $0 cics)))
what jobs does lcs recruit for ?	(lambda $0:e (and_ (job $0) (recruiter $0 LCS)))
show jobs in html ?	(lambda $0:e (and_ (job $0) (language $0 html)))
what database jobs are there ?	(lambda $0:e (and_ (job $0) (area $0 database)))
give me the jobs on unix ?	(lambda $0:e (and_ (job $0) (platform $0 unix)))
are there any jobs for a graphics specialist ?	(lambda $0:e (and_ (job $0) (area $0 graphics)))
what jobs are there using cics ?	(lambda $0:e (and_ (job $0) (language $0 cics)))
are there any unix jobs ?	(lambda $0:e (and_ (job $0) (platform $0 unix)))
show the jobs using html ?	(lambda $0:e (and_ (job $0) (language $0 html)))
i would like to find a job using java ?	(lambda $0:e (and_ (job $0) (language $0 java)))
list the jobs on unix ?	(lambda $0:e (and_ (job $0) (platform $0 unix)))
what jobs are there for a database specialist ?	(lambda $0:e (and_ (job $0) (area $0 database)))
any jobs available using database ?	(lambda $0:e (and_ (job $0) (area $0 database)))
tell me jobs using html ?	(lambda $0:e (and_ (job $0) (language $0 html)))
list the jobs in database ?	(lambda $0:e (and_ (job $0) (area $0 database)))
list the jobs using cics ?	(lambda $0:e (and_ (job $0) (language $0 cics)))
list the jobs for a database specialist ?	(lambda $0:e (and_ (job $0) (area $0 database)))
are there any jobs that require the knowledge of linux platform ?	(lambda $0:e (and_ (job $0) (platform $0 linux)))
what jobs can i find with tivoli ?	(lambda $0:e (and_ (job $0) (company $0 Tivoli)))
what jobs are there using cobol ?	(lambda $0:e (and_ (job $0) (language $0 cobol)))
are there any jobs using cobol ?	(lambda $0:e (and_ (job $0) (language $0 cobol)))
what positions are there in networking ?	(lambda $0:e (and_ (job $0) (area $0 networking)))
what jobs are there for a networking specialist ?	(lambda $0:e (and_ (job $0) (area $0 networking)))
tell me jobs in networking ?	(lambda $0:e (and_ (job $0) (area $0 networking)))
what jobs are there using 'tcl/tk' ?	(lambda $0:e (and_ (job $0) (language $0 tcl/tk)))
are there any computer jobs in the field of statistics ?	(lambda $0:e (and_ (job $0) (area $0 statistics)))
are there any jobs on novell ?	(lambda $0:e (and_ (job $0) (platform $0 novell)))
are there any jobs for a programmer ?	(lambda $0:e (and_ (job $0) (title $0 Programmer)))
are there any programmer jobs open ?	(lambda $0:e (and_ (job $0) (title $0 Programmer)))
are there any programmer jobs open ?	(lambda $0:e (and_ (job $0) (title $0 Programmer)))
is fortran required for any jobs ?	(lambda $0:e (and_ (job $0) (language $0 fortran)))
are there any jobs on windows ?	(lambda $0:e (and_ (job $0) (platform $0 windows)))
show jobs on windows ?	(lambda $0:e (and_ (job $0) (platform $0 windows)))
give me jobs in san antonio ?	(lambda $0:e (and_ (job $0) (loc $0 "san antonio")))
list jobs using assembly ?	(lambda $0:e (and_ (job $0) (language $0 assembly)))
list the positions that require a knowledge of microsoft excel ?	(lambda $0:e (and_ (job $0) (application $0 excel)))
list the positions that require a knowledge of microsoft excel ?	(lambda $0:e (and_ (job $0) (application $0 excel)))
are there any jobs in san antonio ?	(lambda $0:e (and_ (job $0) (loc $0 "san antonio")))
list the jobs using assembly ?	(lambda $0:e (and_ (job $0) (language $0 assembly)))
show the jobs in san antonio ?	(lambda $0:e (and_ (job $0) (loc $0 "san antonio")))
are there any jobs in san antonio ?	(lambda $0:e (and_ (job $0) (loc $0 "san antonio")))
what jobs does microsoft recruit for ?	(lambda $0:e (and_ (job $0) (company $0 Microsoft)))
show me jobs not involving 'c++' ?	(lambda $0:e (and_ (job $0) (not_ (language $0 c++))))
show me jobs not involving 'c++' ?	(lambda $0:e (and_ (job $0) (not_ (language $0 c++))))
what jobs have a salary greater than 20 and hour ?	(lambda $0:e (and_ (job $0) (salary_greater_than $0 20 hour)))
tell me the jobs in '3d' graphics ?	(lambda $0:e (and_ (job $0) (area $0 "3d graphics")))
show me something that requires oracle ?	(lambda $0:e (and_ (job $0) (application $0 oracle)))
what jobs are there for a '3d' graphics specialist ?	(lambda $0:e (and_ (job $0) (area $0 "3d graphics")))
are there any jobs for a client server specialist ?	(lambda $0:e (and_ (job $0) (area $0 client/server)))
what jobs are there for a '3d' graphics specialist ?	(lambda $0:e (and_ (job $0) (area $0 "3d graphics")))
show the jobs in client server ?	(lambda $0:e (and_ (job $0) (area $0 client/server)))
list the jobs for a client server specialist ?	(lambda $0:e (and_ (job $0) (area $0 client/server)))
what jobs are longhorn employment hiring for ?	(lambda $0:e (and_ (job $0) (recruiter $0 Longhorn)))
list jobs in client server ?	(lambda $0:e (and_ (job $0) (area $0 client/server)))
what jobs are longhorn employment hiring for ?	(lambda $0:e (and_ (job $0) (recruiter $0 Longhorn)))
are there any autocad jobs open ?	(lambda $0:e (and_ (job $0) (application $0 autocad)))
list the jobs using cobol ii ?	(lambda $0:e (and_ (job $0) (language $0 "cobol ii")))
list jobs in cobol ii ?	(lambda $0:e (and_ (job $0) (language $0 "cobol ii")))
give me jobs in cobol ii ?	(lambda $0:e (and_ (job $0) (language $0 "cobol ii")))
are there any autocad jobs open ?	(lambda $0:e (and_ (job $0) (application $0 autocad)))
tell me jobs using cobol ii ?	(lambda $0:e (and_ (job $0) (language $0 "cobol ii")))
tell me jobs for a device driver specialist ?	(lambda $0:e (and_ (job $0) (area $0 "device driver")))
what are the jobs that pay 50000 per year ?	(lambda $0:e (and_ (job $0) (salary_greater_than $0 50000 year)))
what jobs are there with a salary of 40000 ?	(lambda $0:e (and_ (job $0) (salary_greater_than $0 40000 year)))
what jobs are there with a salary of more than 50000 dollars per year ?	(lambda $0:e (and_ (job $0) (salary_greater_than $0 50000 year)))
show me jobs with a salary greater than 50000 dollars a year ?	(lambda $0:e (and_ (job $0) (salary_greater_than $0 50000 year)))
show me the jobs with 30000 salary	(lambda $0:e (and_ (job $0) (salary_greater_than $0 30000 year)))
what jobs are there with a salary of 40000 ?	(lambda $0:e (and_ (job $0) (salary_greater_than $0 40000 year)))
what jobs pay 40000 ?	(lambda $0:e (and_ (job $0) (salary_greater_than $0 40000 year)))
show me the jobs with 30000 salary	(lambda $0:e (and_ (job $0) (salary_greater_than $0 30000 year)))
show me jobs paying greater than 50000 per year ?	(lambda $0:e (and_ (job $0) (salary_greater_than $0 50000 year)))
what jobs pay at least 80000 dollars per year ?	(lambda $0:e (and_ (job $0) (salary_greater_than $0 80000 year)))
list the jobs in visual 'c++' ?	(lambda $0:e (and_ (job $0) (language $0 "visual c++")))
tell me the jobs using powerbuilder ?	(lambda $0:e (and_ (job $0) (language $0 powerbuilder)))
give me jobs using visual 'c++' ?	(lambda $0:e (and_ (job $0) (language $0 "visual c++")))
which jobs use visual 'j++' as their development tool ?	(lambda $0:e (and_ (job $0) (language $0 "visual j++")))
which jobs use visual 'j++' as their development tool ?	(lambda $0:e (and_ (job $0) (language $0 "visual j++")))
what jobs are there on windows 95 ?	(lambda $0:e (and_ (job $0) (platform $0 "windows 95")))
show the jobs in visual 'c++' ?	(lambda $0:e (and_ (job $0) (language $0 "visual c++")))
give me the jobs in visual 'c++' ?	(lambda $0:e (and_ (job $0) (language $0 "visual c++")))
are there any jobs using powerbuilder ?	(lambda $0:e (and_ (job $0) (language $0 powerbuilder)))
tell me the jobs on windows nt ?	(lambda $0:e (and_ (job $0) (platform $0 "windows nt")))
what jobs are there on windows nt ?	(lambda $0:e (and_ (job $0) (platform $0 "windows nt")))
show jobs using powerbuilder ?	(lambda $0:e (and_ (job $0) (language $0 powerbuilder)))
show me the jobs that are not in haskell ?	(lambda $0:e (and_ (job $0) (not_ (language $0 haskell))))
i want a job that doesnt use windows ?	(lambda $0:e (and_ (job $0) (not_ (platform $0 windows))))
show me the jobs that are not in haskell ?	(lambda $0:e (and_ (job $0) (not_ (language $0 haskell))))
are there any jobs with a salary of 100000 ?	(lambda $0:e (and_ (job $0) (salary_greater_than $0 100000 year)))
what jobs have a recruiter named phil smith ?	(lambda $0:e (and_ (job $0) (recruiter $0 "Phil Smith")))
are there any jobs for a data warehousing specialist ?	(lambda $0:e (and_ (job $0) (area $0 "data warehousing")))
tell me the jobs using visual basic ?	(lambda $0:e (and_ (job $0) (language $0 "visual basic")))
what jobs are there in data warehousing ?	(lambda $0:e (and_ (job $0) (area $0 "data warehousing")))
are there any project manager positions open ?	(lambda $0:e (and_ (job $0) (title $0 "Project Manager")))
show jobs for a data warehousing specialist ?	(lambda $0:e (and_ (job $0) (area $0 "data warehousing")))
give me jobs for a data warehousing specialist ?	(lambda $0:e (and_ (job $0) (area $0 "data warehousing")))
tell me jobs using visual basic ?	(lambda $0:e (and_ (job $0) (language $0 "visual basic")))
show jobs using visual basic ?	(lambda $0:e (and_ (job $0) (language $0 "visual basic")))
are there any project manager positions open ?	(lambda $0:e (and_ (job $0) (title $0 "Project Manager")))
list the required experience for a job using lisp ?	(lambda $1:e (exists_ $0:e (and_ (job $0) (language $0 lisp) (req_exp $0 $1))))
show me the job application for ic design engineer ?	(lambda $0:e (and_ (job $0) (title $0 "Ic Design Engineer")))
what jobs desire a degree but dont use 'c++'	(lambda $0:e (and_ (job $0) (not_ (language $0 c++)) (des_deg $0)))
what jobs desire a degree but dont use 'c++'	(lambda $0:e (and_ (job $0) (not_ (language $0 c++)) (des_deg $0)))
how much experience is wanted for a job at microsoft ?	(lambda $1:e (exists_ $0:e (and_ (job $0) (company $0 Microsoft) (req_exp $0 $1))))
are there any jobs in the us with the title verification engineer ?	(lambda $0:e (and_ (job $0) (title $0 "Verification Engineer")))
what are the degree requirements for a software engineer ?	(lambda $1:e (exists_ $0:e (and_ (title $0 "Software Engineer") (req_deg $0 $1))))
list the companies that desire 'c++' experience ?	(lambda $1:e (exists_ $0:e (and_ (job $0) (language $0 c++) (des_exp $0) (company $0 $1))))
what project manager jobs are there that require experience ?	(lambda $0:e (and_ (job $0) (title $0 "Project Manager") (req_exp $0)))
what are the jobs that require experience with microsoft word ?	(lambda $0:e (and_ (job $0) (application $0 "microsoft word") (req_exp $0)))
what are the jobs that require experience with microsoft word ?	(lambda $0:e (and_ (job $0) (application $0 "microsoft word") (req_exp $0)))
show the jobs for bscs in austin ?	(lambda $0:e (and_ (req_deg $0 BSCS) (loc $0 austin)))
tell me the jobs requiring bs in usa ?	(lambda $0:e (and_ (job $0) (req_deg $0 BS) (loc $0 usa)))
are there jobs that do not require a degree in houston ?	(lambda $0:e (and_ (job $0) (loc $0 houston) (not_ (req_deg $0))))
are there any jobs specializing in ai with jpl ?	(lambda $0:e (and_ (job $0) (area $0 ai) (company $0 JPL)))
show me the jobs that require 1 year of experience but desire 2 years of experiences	(lambda $0:e (and_ (job $0) (req_exp $0 1) (des_exp $0 2)))
are there any jobs specializing in ai with jpl ?	(lambda $0:e (and_ (job $0) (area $0 ai) (company $0 JPL)))
what jobs need knowledge of 'c++' or java ?	(lambda $0:e (and_ (job $0) (or_ (language $0 c++) (language $0 java))))
what jobs are there in usa on ibm ?	(lambda $0:e (and_ (job $0) (loc $0 usa) (platform $0 ibm)))
what ai positions require only a bscs ?	(lambda $0:e (and_ (job $0) (area $0 ai) (req_deg $0 BSCS)))
what jobs are there in austin that require 5 years experience ?	(lambda $0:e (and_ (job $0) (loc $0 austin) (req_exp $0 5)))
what jobs in austin require 10 years of experience ?	(lambda $0:e (and_ (job $0) (loc $0 austin) (req_exp $0 10)))
give me the jobs for a database specialist in usa ?	(lambda $0:e (and_ (job $0) (area $0 database) (loc $0 usa)))
show the jobs requiring bs in usa ?	(lambda $0:e (and_ (job $0) (req_deg $0 BS) (country $0 usa)))
what job is there for a bscs with 5 years of experience ?	(lambda $0:e (and_ (job $0) (req_deg $0 BSCS) (req_exp $0 5)))
what jobs require at least 1 year of experience in 'c++' ?	(lambda $0:e (and_ (job $0) (req_exp $0 1) (language $0 c++)))
what jobs in austin require no experience ?	(lambda $0:e (and_ (job $0) (loc $0 austin) (not_ (req_exp $0))))
what jobs in austin require no experience ?	(lambda $0:e (and_ (job $0) (loc $0 austin) (not_ (req_exp $0))))
give some jobs in dallas on a sun system ?	(lambda $0:e (and_ (job $0) (loc $0 dallas) (platform $0 sun)))
show jobs in austin that require a bscs ?	(lambda $0:e (and_ (job $0) (loc $0 austin) (req_deg $0 BSCS)))
what jobs are there in dallas that requires a mscs ?	(lambda $0:e (and_ (job $0) (loc $0 dallas) (req_deg $0 MSCS)))
whats available on vax and near austin ?	(lambda $0:e (and_ (job $0) (platform $0 vax) (loc $0 austin)))
show me the jobs at companies in austin that want a degree in bscs	(lambda $0:e (and_ (job $0) (loc $0 austin) (des_deg $0 BSCS)))
find all network administration jobs in austin ?	(lambda $0:e (and_ (job $0) (area $0 network) (loc $0 austin)))
show me austin jobs requiring a bscs ?	(lambda $0:e (and_ (job $0) (loc $0 austin) (req_deg $0 BSCS)))
what 'c++' jobs are in austin ?	(lambda $0:e (and_ (job $0) (language $0 c++) (loc $0 austin)))
show me austin jobs desiring a bscs	(lambda $0:e (and_ (job $0) (loc $0 austin) (des_deg $0 BSCS)))
show jobs in austin that require a bscs ?	(lambda $0:e (and_ (job $0) (loc $0 austin) (req_deg $0 BSCS)))
what jobs in boston have openings for a 'c++' programmer ?	(lambda $0:e (and_ (job $0) (loc $0 boston) (language $0 c++)))
find all network administration jobs in austin ?	(lambda $0:e (and_ (job $0) (area $0 network) (loc $0 austin)))
what jobs in boston have openings for a 'c++' programmer ?	(lambda $0:e (and_ (job $0) (loc $0 boston) (language $0 c++)))
show me the jobs at companies in austin that want a degree in bscs	(lambda $0:e (and_ (job $0) (loc $0 austin) (des_deg $0 BSCS)))
find all 'c++' jobs in austin ?	(lambda $0:e (and_ (job $0) (language $0 c++) (loc $0 austin)))
what 'c++' jobs are in austin ?	(lambda $0:e (and_ (job $0) (language $0 c++) (loc $0 austin)))
i hold a degree in bscs in austin are there any jobs for me ?	(lambda $0:e (and_ (job $0) (des_deg $0 BSCS) (loc $0 austin)))
show me dallas jobs requiring a bscs ?	(lambda $0:e (and_ (job $0) (loc $0 dallas) (req_deg $0 BSCS)))
what jobs are there in austin that require a bscs degree ?	(lambda $0:e (and_ (job $0) (loc $0 austin) (req_deg $0 BSCS)))
i wish there were some perl jobs in boston ?	(lambda $0:e (and_ (job $0) (language $0 perl) (loc $0 boston)))
show me the jobs requiring 3 years of experience at tivoli ?	(lambda $0:e (and_ (job $0) (req_exp $0 3) (company $0 Tivoli)))
what jobs in austin require knowledge of the platform unix ?	(lambda $0:e (and_ (job $0) (loc $0 austin) (platform $0 unix)))
what jobs in austin need knowledge in unix ?	(lambda $0:e (and_ (job $0) (loc $0 austin) (platform $0 unix)))
what are the jobs in washington that require at least 5 years of experience ?	(lambda $0:e (and_ (job $0) (loc $0 washington) (req_exp $0 5)))
list the jobs using html for a games specialist ?	(lambda $0:e (and_ (job $0) (language $0 html) (area $0 games)))
what jobs in houston require a bacs ?	(lambda $0:e (and_ (job $0) (loc $0 houston) (req_deg $0 BACS)))
show the jobs on pc requiring bscs ?	(lambda $0:e (and_ (job $0) (platform $0 pc) (req_deg $0 BSCS)))
what jobs require a bscs and no experience ?	(lambda $0:e (and_ (job $0) (req_deg $0 BSCS) (not_ (req_exp $0))))
do you have any jobs involving 'c++' on aix ?	(lambda $0:e (and_ (job $0) (language $0 c++) (platform $0 aix)))
are there any jobs using 'c++' with dell ?	(lambda $0:e (and_ (job $0) (language $0 c++) (company $0 Dell)))
tell me the jobs requiring ba using cobol ?	(lambda $0:e (and_ (job $0) (req_deg $0 BA) (language $0 cobol)))
what jobs require a bscs degree and desire an mscs degree ?	(lambda $0:e (and_ (job $0) (req_deg $0 BSCS) (des_deg $0 MSCS)))
what jobs at dell require a bscs ?	(lambda $0:e (and_ (job $0) (company $0 Dell) (req_deg $0 BSCS)))
are there any jobs using assembly in usa ?	(lambda $0:e (and_ (job $0) (language $0 assembly) (loc $0 usa)))
are there any jobs using 'c++' with dell ?	(lambda $0:e (and_ (job $0) (language $0 c++) (company $0 Dell)))
give me jobs on vms using sql ?	(lambda $0:e (and_ (job $0) (platform $0 vms) (language $0 sql)))
show me jobs at dell requiring a bscs degree ?	(lambda $0:e (and_ (job $0) (company $0 Dell) (req_deg $0 BSCS)))
show me jobs requiring a bscs on sun ?	(lambda $0:e (and_ (job $0) (req_deg $0 BSCS) (platform $0 sun)))
show me jobs requiring a bscs on suns ?	(lambda $0:e (and_ (job $0) (req_deg $0 BSCS) (platform $0 sun)))
what jobs are there that dont require a degree but use perl ?	(lambda $0:e (and_ (job $0) (not_ (req_deg $0)) (language $0 perl)))
what jobs use html but do not require a degree ?	(lambda $0:e (and_ (job $0) (language $0 html) (not_ (req_deg $0))))
show the jobs with the title systems programmer requiring 2 years of experience	(lambda $0:e (and_ (job $0) (title $0 Programmer) (req_exp $0 2)))
show me programmer jobs in tulsa ?	(lambda $0:e (and_ (job $0) (title $0 Programmer) (loc $0 tulsa)))
show me the jobs using lisp requiring a bscs ?	(lambda $0:e (and_ (job $0) (language $0 lisp) (req_deg $0 BSCS)))
give me jobs on the mac using perl ?	(lambda $0:e (and_ (job $0) (platform $0 mac) (language $0 perl)))
list jobs requiring bscs using java ?	(lambda $0:e (and_ (job $0) (req_deg $0 BSCS) (language $0 java)))
show me programmer jobs in tulsa ?	(lambda $0:e (and_ (job $0) (title $0 Programmer) (loc $0 tulsa)))
what positions are there that use 'c++' and java ?	(lambda $0:e (and_ (job $0) (language $0 c++) (language $0 java)))
show me the jobs using lisp requiring a bscs ?	(lambda $0:e (and_ (job $0) (language $0 lisp) (req_deg $0 BSCS)))
where can i work with a bscs and no experience ?	(lambda $1:e (exists_ $0:e (and_ (job $0) (req_deg $0 BSCS) (not_ (req_exp $0)) (loc $0 $1))))
show me new york jobs requiring a bscs ?	(lambda $0:e (and_ (job $0) (loc $0 "new york") (req_deg $0 BSCS)))
what tivoli jobs are there that require a bscs degree ?	(lambda $0:e (and_ (job $0) (company $0 Tivoli) (req_deg $0 BSCS)))
which jobs at trilogy deal with 'c++' ?	(lambda $0:e (and_ (job $0) (company $0 Trilogy) (language $0 c++)))
show jobs for a shell programmer familiar with the unix environment ?	(lambda $0:e (and_ (job $0) (language $0 shell) (platform $0 unix)))
what jobs using fortran are there in houston ?	(lambda $0:e (and_ (job $0) (language $0 fortran) (loc $0 houston)))
which jobs at trilogy deal with 'c++' ?	(lambda $0:e (and_ (job $0) (company $0 Trilogy) (language $0 c++)))
show a list of jobs requiring experience in 'c++' or java ?	(lambda $0:e (and_ (job $0) (or_ (language $0 c++) (language $0 java)) (req_exp $0)))
is anyone offering 40000 for ai work ?	(lambda $0:e (and_ (job $0) (salary_greater_than $0 40000 year) (area $0 ai)))
what are the jobs in austin requiring knowledge of oracle ?	(lambda $0:e (and_ (job $0) (loc $0 austin) (application $0 oracle)))
show the companies that are looking for bscs in austin	(lambda $1:e (exists_ $0:e (and_ (req_deg $0 BSCS) (loc $0 austin) (company $0 $1))))
are there any mac programmer jobs ?	(lambda $0:e (and_ (job $0) (platform $0 mac) (title $0 Programmer)))
are there any mac programmer jobs ?	(lambda $0:e (and_ (job $0) (platform $0 mac) (title $0 Programmer)))
what jobs are there in austin for people with knowledge of the application oracle ?	(lambda $0:e (and_ (job $0) (loc $0 austin) (application $0 oracle)))
what jobs are there for assembly programmer that require a bscs ?	(lambda $0:e (and_ (job $0) (language $0 assembly) (req_deg $0 BSCS)))
are there any jobs using java that are not with ibm ?	(lambda $0:e (and_ (job $0) (language $0 java) (not_ (company $0 IBM))))
what jobs are there for programmers who know java ?	(lambda $0:e (and_ (job $0) (title $0 Programmer) (language $0 java)))
i sure do wish there were java assembly jobs out there '.' can you help ?	(lambda $0:e (and_ (job $0) (language $0 java) (language $0 assembly)))
could i have some jobs using sql with oracle ?	(lambda $0:e (and_ (job $0) (language $0 sql) (application $0 oracle)))
show me the jobs concerning games development on a playstation ?	(lambda $0:e (and_ (job $0) (area $0 games) (platform $0 playstation)))
are there any jobs using java that dont require a bscs ?	(lambda $0:e (and_ (job $0) (language $0 java) (not_ (req_deg $0 BSCS))))
show the jobs using lisp not requiring a bscs	(lambda $0:e (and_ (job $0) (language $0 lisp) (not_ (req_deg $0 BSCS))))
what jobs require knowledge of 'c++' but not perl ?	(lambda $0:e (and_ (job $0) (language $0 c++) (not_ (language $0 perl))))
what jobs require knowledge of 'c++' but not perl ?	(lambda $0:e (and_ (job $0) (language $0 c++) (not_ (language $0 perl))))
show the jobs using lisp not requiring a degree in cs ?	(lambda $0:e (and_ (job $0) (language $0 lisp) (not_ (req_deg $0 BSCS))))
show me austin jobs with a salary of 50000	(lambda $0:e (and_ (job $0) (loc $0 austin) (salary_greater_than $0 50000 year)))
what jobs in austin have a salary of 60000 ?	(lambda $0:e (and_ (job $0) (loc $0 austin) (salary_greater_than $0 60000 year)))
what jobs in austin have a salary of 60000 ?	(lambda $0:e (and_ (job $0) (loc $0 austin) (salary_greater_than $0 60000 year)))
what are the positions within hp that pay 40000 per year ?	(lambda $0:e (and_ (job $0) (company $0 HP) (salary_greater_than $0 40000 year)))
what are the positions within hp that pay 40000 per year ?	(lambda $0:e (and_ (job $0) (company $0 HP) (salary_greater_than $0 40000 year)))
show me austin jobs with a salary of 50000	(lambda $0:e (and_ (job $0) (loc $0 austin) (salary_greater_than $0 50000 year)))
give me jobs in san antonio using cobol ?	(lambda $0:e (and_ (job $0) (loc $0 "san antonio") (language $0 cobol)))
what web developer jobs are there in austin ?	(lambda $0:e (and_ (job $0) (title $0 "Web Developer") (loc $0 austin)))
are there any jobs that require a knowledge of linux in san antonio ?	(lambda $0:e (and_ (job $0) (platform $0 linux) (loc $0 "san antonio")))
what jobs in san antonio require the use of cobol ?	(lambda $0:e (and_ (job $0) (loc $0 "san antonio") (language $0 cobol)))
what jobs are there in austin with a salary of at least 100000 per year ?	(lambda $0:e (and_ (job $0) (loc $0 austin) (salary_greater_than $0 100000 year)))
are there any jobs in austin paying over 100000 per year ?	(lambda $0:e (and_ (job $0) (loc $0 austin) (salary_greater_than $0 100000 year)))
what jobs using fortran are there in los alamos ?	(lambda $0:e (and_ (job $0) (language $0 fortran) (loc $0 "los alamos")))
show the jobs with the title systems analyst requiring 2 years of experience ?	(lambda $0:e (and_ (job $0) (title $0 "Systems Analyst") (req_exp $0 2)))
what jobs are there for pascal programers who dont know 'c++'	(lambda $0:e (and_ (job $0) (language $0 pascal) (not_ (language $0 c++))))
are there any jobs using java that are not with tivoli ?	(lambda $0:e (and_ (job $0) (language $0 java) (not_ (company $0 Tivoli))))
what jobs in dallas require experience with unix ?	(lambda $0:e (and_ (job $0) (loc $0 dallas) (platform $0 unix) (req_exp $0)))
what jobs are there in austin that requires experience with unix ?	(lambda $0:e (and_ (job $0) (loc $0 austin) (platform $0 unix) (req_exp $0)))
what locations offer jobs using java on sun ?	(lambda $1:e (exists_ $0:e (and_ (job $0) (language $0 java) (platform $0 sun) (loc $0 $1))))
can i find a job making more than 40000 a year without a degree ?	(lambda $0:e (and_ (job $0) (salary_greater_than $0 40000 year) (not_ (req_deg $0))))
what jobs do not require a degree but pay more than 60000 ?	(lambda $0:e (and_ (job $0) (not_ (req_deg $0)) (salary_greater_than $0 60000 year)))
are there any jobs in 'c++' that the salary is 50000 ?	(lambda $0:e (and_ (job $0) (language $0 c++) (salary_greater_than $0 50000 year)))
what jobs pay 40000 per year that require a bscs ?	(lambda $0:e (and_ (job $0) (salary_greater_than $0 40000 year) (req_deg $0 BSCS)))
show me jobs at dell earning 60000	(lambda $0:e (and_ (job $0) (company $0 Dell) (salary_greater_than $0 60000 year)))
what are the jobs using 'c++' with salaries of 50000 ?	(lambda $0:e (and_ (job $0) (language $0 c++) (salary_greater_than $0 50000 year)))
can you offer anything with at least 60000 on a sun ?	(lambda $0:e (and_ (job $0) (salary_greater_than $0 60000 year) (platform $0 sun)))
what do you have paying over 40000 on the vax ?	(lambda $0:e (and_ (job $0) (salary_greater_than $0 40000 year) (platform $0 vax)))
what jobs pay 40000 per year that desire a bscs ?	(lambda $0:e (and_ (job $0) (salary_greater_than $0 40000 year) (des_deg $0 BSCS)))
what jobs require 'c++' and pays a salary greater than 90000 per year ?	(lambda $0:e (and_ (job $0) (language $0 c++) (salary_greater_than $0 90000 year)))
what jobs are there for web developer who know 'c++' ?	(lambda $0:e (and_ (job $0) (title $0 "Web Developer") (language $0 c++)))
what jobs are there outside austin which pay less than 60000 per year ?	(lambda $0:e (and_ (job $0) (not_ (loc $0 austin)) (salary_less_than $0 60000 year)))
what jobs are available using apache with a specialty area of networking ?	(lambda $0:e (and_ (job $0) (application $0 apache) (area $0 networking)))
what jobs are there for web developer who know 'c++' ?	(lambda $0:e (and_ (job $0) (title $0 "Web Developer") (language $0 c++)))
what systems analyst jobs are there in austin ?	(lambda $0:e (and_ (job $0) (title $0 "Systems Analyst") (loc $0 austin)))
give me 'c++' jobs on windows nt ?	(lambda $0:e (and_ (job $0) (platform $0 "windows nt") (language $0 c++)))
what jobs are available using apache with a specialty area of networking ?	(lambda $0:e (and_ (job $0) (application $0 apache) (area $0 networking)))
give me the jobs using 'c++' that dont require windows ?	(lambda $0:e (and_ (job $0) (language $0 c++) (not_ (platform $0 windows))))
what jobs are there for programmers that know assembly ?	(lambda $0:e (and_ (job $0) (title $0 Programmer) (language $0 assembly)))
what jobs are in seattle that are not at microsoft ?	(lambda $0:e (and_ (job $0) (loc $0 seattle) (not_ (company $0 Microsoft))))
show me the jobs using java with salaries greater than 50000	(lambda $0:e (and_ (job $0) (language $0 java) (salary_greater_than $0 50000 year)))
what jobs are there for a test engineer using java ?	(lambda $0:e (and_ (job $0) (title $0 "Test Engineer") (language $0 java)))
show me systems analyst jobs at ibm ?	(lambda $0:e (and_ (job $0) (title $0 "Systems Analyst") (company $0 IBM)))
show me jobs with the playstation in the specialty area of animation ?	(lambda $0:e (and_ (job $0) (platform $0 playstation) (area $0 animation)))
what microsoft jobs do not require a bscs ?	(lambda $0:e (and_ (job $0) (company $0 Microsoft) (not_ (req_deg $0 BSCS))))
what microsoft jobs do not require a bscs ?	(lambda $0:e (and_ (job $0) (company $0 Microsoft) (not_ (req_deg $0 BSCS))))
what jobs are available for someone who knows oracle on solaris ?	(lambda $0:e (and_ (job $0) (platform $0 solaris) (application $0 oracle)))
show me jobs are dell requiring experience on unix ?	(lambda $0:e (and_ (job $0) (company $0 Dell) (platform $0 unix) (req_exp $0)))
show me jobs for dell requiring experience on unix ?	(lambda $0:e (and_ (job $0) (company $0 Dell) (platform $0 unix) (req_exp $0)))
show me all of the software engineer jobs in austin ?	(lambda $0:e (and_ (job $0) (title $0 "Software Engineer") (loc $0 austin)))
show me graphics jobs which phil smith is recruiting for ?	(lambda $0:e (and_ (job $0) (area $0 graphics) (recruiter $0 "Phil Smith")))
show me graphics jobs which phil smith is recruiting for ?	(lambda $0:e (and_ (job $0) (area $0 graphics) (recruiter $0 "Phil Smith")))
are there any software developer jobs requiring bs ?	(lambda $0:e (and_ (job $0) (title $0 "Software Developer") (req_deg $0 BS)))
show me the research assistant job in austin	(lambda $0:e (and_ (job $0) (title $0 "research assistant") (loc $0 austin)))
show me the research assistant job in austin	(lambda $0:e (and_ (job $0) (title $0 "research assistant") (loc $0 austin)))
show me web developer job openings at trilogy ?	(lambda $0:e (and_ (job $0) (title $0 "Web Developer") (company $0 Trilogy)))
show me developer jobs requiring experience with mac ?	(lambda $0:e (and_ (job $0) (title $0 Developer) (platform $0 mac) (req_exp $0)))
who gives 50000 for fortran ?	(lambda $0:e (and_ (job $0) (salary_greater_than $0 50000 year) (language $0 fortran)))
which jobs pay 60000 that do not require a phd ?	(lambda $0:e (and_ (job $0) (salary_greater_than $0 60000 year) (not_ (req_deg $0 PhD))))
what are the software engineering jobs available using ada ?	(lambda $0:e (and_ (job $0) (language $0 ada) (title $0 "Software Engineer")))
what software engineer jobs are there that use 'c++' ?	(lambda $0:e (and_ (job $0) (title $0 "Software Engineer") (language $0 c++)))
show me systems analyst jobs at tivoli ?	(lambda $0:e (and_ (job $0) (title $0 "Systems Analyst") (company $0 Tivoli)))
what are the software engineer jobs available using ada ?	(lambda $0:e (and_ (job $0) (title $0 "Software Engineer") (language $0 ada)))
does apple have any software engineer positions ?	(lambda $0:e (and_ (job $0) (company $0 Apple) (title $0 "Software Engineer")))
what jobs are there for a visual basic developer ?	(lambda $0:e (and_ (job $0) (language $0 "visual basic") (title $0 Developer)))
what job is there for 'c++' but not visual 'c++' ?	(lambda $0:e (and_ (job $0) (language $0 c++) (not_ (language $0 "visual c++"))))
are there any systems administrator jobs in austin ?	(lambda $0:e (and_ (job $0) (title $0 "Systems Administrator") (loc $0 austin)))
what programming languages are desired for a job as a programmer at ibm ?	(lambda $1:e (exists_ $0:e (and_ (job $0) (title $0 Programmer) (company $0 IBM) (language $0 $1))))
what jobs require a bscs and experience with oracle ?	(lambda $0:e (and_ (job $0) (req_deg $0 BSCS) (application $0 oracle) (req_exp $0)))
what system administrator jobs are available from dell ?	(lambda $0:e (and_ (job $0) (title $0 "System Administrator") (company $0 Dell)))
what jobs pay 60000 are located in austin and require a degree ?	(lambda $0:e (and_ (job $0) (salary_greater_than $0 60000 year) (loc $0 austin) (req_deg $0)))
what jobs are there doing computer graphics on silicon graphics machines ?	(lambda $0:e (and_ (job $0) (area $0 graphics) (platform $0 "silicon graphics")))
what system administrator jobs are available from dell ?	(lambda $0:e (and_ (job $0) (title $0 "System Administrator") (company $0 Dell)))
give me jobs that require ethernet experience but no html ?	(lambda $0:e (and_ (job $0) (area $0 ethernet) (not_ (language $0 html)) (req_exp $0)))
what jobs in austin require 5 years of experience but desire 10 years of experience ?	(lambda $0:e (and_ (job $0) (loc $0 austin) (req_exp $0 5) (des_exp $0 10)))
show me the jobs in texas using ai on unix ?	(lambda $0:e (and_ (job $0) (loc $0 texas) (area $0 ai) (platform $0 unix)))
show me the jobs in texas using ai on unix ?	(lambda $0:e (and_ (job $0) (loc $0 texas) (area $0 ai) (platform $0 unix)))
what jobs in austin require 5 years of experience but desire 10 years of experience ?	(lambda $0:e (and_ (job $0) (loc $0 austin) (req_exp $0 5) (des_exp $0 10)))
what jobs require a degree for pascal programmers who do not know 'c++' ?	(lambda $0:e (and_ (job $0) (language $0 pascal) (not_ (language $0 c++)) (req_deg $0)))
does national instruments have any positions that dont require experience ?	(lambda $0:e (and_ (job $0) (company $0 "National Instruments") (not_ (req_exp $0))))
does national instruments have any positions that dont require experience ?	(lambda $0:e (and_ (job $0) (company $0 "National Instruments") (not_ (req_exp $0))))
what jobs as an sql engineer pay 100000 ?	(lambda $0:e (and_ (job $0) (title $0 "Sql Engineer") (salary_greater_than $0 100000 year)))
show me the jobs in austin that desire 3 years of experience and use 'c++' ?	(lambda $0:e (and_ (job $0) (loc $0 austin) (des_exp $0 3) (language $0 c++)))
show me the jobs in austin that desire 3 years of experience and use 'c++' ?	(lambda $0:e (and_ (job $0) (loc $0 austin) (des_exp $0 3) (language $0 c++)))
what web related jobs require a bscs but no experience ?	(lambda $0:e (and_ (job $0) (area $0 web) (req_deg $0 BSCS) (not_ (req_exp $0))))
show me programmer jobs requiring no experience on unix ?	(lambda $0:e (and_ (job $0) (title $0 Programmer) (platform $0 unix) (not_ (req_exp $0))))
what jobs in houston are there that requires a bscs with 1 year of experience ?	(lambda $0:e (and_ (job $0) (loc $0 houston) (req_deg $0 BSCS) (req_exp $0 1)))
what jobs use 'c++' with the web on macs ?	(lambda $0:e (and_ (job $0) (language $0 c++) (area $0 web) (platform $0 mac)))
what jobs in ibm in austin do not need a degree ?	(lambda $0:e (and_ (job $0) (company $0 IBM) (loc $0 austin) (not_ (req_deg $0))))
could a senior consulting engineer find work in boston ?	(lambda $0:e (and_ (job $0) (title $0 "Senior Consulting Engineer") (loc $0 boston)))
what jobs in austin require a bscs degree and deal with 'tcp/ip' ?	(lambda $0:e (and_ (job $0) (loc $0 austin) (req_deg $0 BSCS) (area $0 tcp/ip)))
what jobs in austin only require a bscs and no experience ?	(lambda $0:e (and_ (job $0) (loc $0 austin) (req_deg $0 BSCS) (not_ (req_exp $0))))
what jobs are there in texas that use java and require no experience ?	(lambda $0:e (and_ (job $0) (loc $0 texas) (language $0 java) (not_ (req_exp $0))))
what jobs are there in texas that use java and require no experience ?	(lambda $0:e (and_ (job $0) (loc $0 texas) (language $0 java) (not_ (req_exp $0))))
show me 'c++' jobs requiring a bscs in austin ?	(lambda $0:e (and_ (job $0) (language $0 c++) (req_deg $0 BSCS) (loc $0 austin)))
what are the 'c++' jobs in austin requiring a bscs ?	(lambda $0:e (and_ (job $0) (language $0 c++) (loc $0 austin) (req_deg $0 BSCS)))
show me houston jobs using 'c++' on pc ?	(lambda $0:e (and_ (job $0) (loc $0 houston) (language $0 c++) (platform $0 pc)))
what java jobs are there with ibm in austin ?	(lambda $0:e (and_ (job $0) (language $0 java) (company $0 IBM) (loc $0 austin)))
show me the 'c++' jobs in nashville that desire 2 years experience	(lambda $0:e (and_ (job $0) (language $0 c++) (loc $0 nashville) (des_exp $0 2)))
show me a dell job in austin requiring a bscs ?	(lambda $0:e (and_ (job $0) (company $0 Dell) (loc $0 austin) (req_deg $0 BSCS)))
what are the 'c++' jobs in austin requiring a bscs ?	(lambda $0:e (and_ (job $0) (language $0 c++) (loc $0 austin) (req_deg $0 BSCS)))
show me 'c++' jobs requiring a bscs in austin ?	(lambda $0:e (and_ (job $0) (language $0 c++) (req_deg $0 BSCS) (loc $0 austin)))
list the jobs requiring java a bscs 2 years experience	(lambda $0:e (and_ (job $0) (language $0 java) (req_deg $0 BSCS) (req_exp $0 2)))
show me a dell job in austin requiring a bscs ?	(lambda $0:e (and_ (job $0) (company $0 Dell) (loc $0 austin) (req_deg $0 BSCS)))
what jobs in austin desiring a bscs are there for a 'c++' programmer ?	(lambda $0:e (and_ (job $0) (loc $0 austin) (des_deg $0 BSCS) (language $0 c++)))
are there any jobs for people in austin that want to program in lisp but do not have a degree ?	(lambda $0:e (and_ (job $0) (loc $0 austin) (language $0 lisp) (not_ (req_deg $0))))
are there any jobs for people in austin that want to program in lisp but do not have a degree ?	(lambda $0:e (and_ (job $0) (loc $0 austin) (language $0 lisp) (not_ (req_deg $0))))
show me a job that requires 'c++' and java and is in austin ?	(lambda $0:e (and_ (job $0) (language $0 c++) (language $0 java) (loc $0 austin)))
what jobs in austin use 'c++' and java ?	(lambda $0:e (and_ (job $0) (loc $0 austin) (language $0 c++) (language $0 java)))
show me jobs at dell requiring no experience and a bscs ?	(lambda $0:e (and_ (job $0) (company $0 Dell) (not_ (req_exp $0)) (req_deg $0 BSCS)))
what austin jobs that use cobol do not require any experience ?	(lambda $0:e (and_ (job $0) (loc $0 austin) (language $0 cobol) (not_ (req_exp $0))))
show me jobs at dell requiring no experience and a bscs ?	(lambda $0:e (and_ (job $0) (company $0 Dell) (not_ (req_exp $0)) (req_deg $0 BSCS)))
show me the hardware platforms associated with a netware administrator with ibm ?	(lambda $1:e (exists_ $0:e (and_ (title $0 "NetWare Administrator") (company $0 IBM) (platform $0 $1))))
show me the senior software developer jobs which require a master ?	(lambda $0:e (and_ (job $0) (title $0 "Senior Software Developer") (req_deg $0 master)))
are there any jobs in austin requiring at least a bscs and knowing latex ?	(lambda $0:e (and_ (job $0) (loc $0 austin) (req_deg $0 BSCS) (language $0 latex)))
show me the jobs using 'c++' that require a bscs but desire a mscs ?	(lambda $0:e (and_ (job $0) (language $0 c++) (req_deg $0 BSCS) (des_deg $0 MSCS)))
show me the jobs using 'c++' that require a bscs but desire a mscs ?	(lambda $0:e (and_ (job $0) (language $0 c++) (req_deg $0 BSCS) (des_deg $0 MSCS)))
which jobs in austin offer for students fresh out of college in networking ?	(lambda $0:e (and_ (job $0) (loc $0 austin) (not_ (req_exp $0)) (area $0 networking)))
which jobs in austin offer for students fresh out of college in networking ?	(lambda $0:e (and_ (job $0) (loc $0 austin) (not_ (req_exp $0)) (area $0 networking)))
what ai jobs are there in texas that pay 65000 ?	(lambda $0:e (and_ (job $0) (area $0 ai) (loc $0 texas) (salary_greater_than $0 65000 year)))
are there any jobs requiring a bscs for boeing in seattle ?	(lambda $0:e (and_ (job $0) (req_deg $0 BSCS) (company $0 Boeing) (loc $0 seattle)))
what jobs on pc are for programming assembly and desire 5 years experience ?	(lambda $0:e (and_ (job $0) (platform $0 pc) (language $0 assembly) (des_exp $0 5)))
what jobs on pc are for programming assembly and desire 5 years experience ?	(lambda $0:e (and_ (job $0) (platform $0 pc) (language $0 assembly) (des_exp $0 5)))
show me jobs using lisp that require a bscs and desire a msee ?	(lambda $0:e (and_ (job $0) (language $0 lisp) (req_deg $0 BSCS) (des_deg $0 MSEE)))
what programmer positions in austin require no experience ?	(lambda $0:e (and_ (job $0) (title $0 Programmer) (loc $0 austin) (not_ (req_exp $0))))
show me the senior development engineer jobs which require a master ?	(lambda $0:e (and_ (job $0) (title $0 "Senior Development Engineer") (req_deg $0 master)))
what are the jobs for a 'c++' programmer in austin ?	(lambda $0:e (and_ (job $0) (language $0 c++) (title $0 Programmer) (loc $0 austin)))
show me jobs located in austin for 'c++' programmers ?	(lambda $0:e (and_ (job $0) (loc $0 austin) (language $0 c++) (title $0 Programmer)))
are there any mac programmer jobs open in austin ?	(lambda $0:e (and_ (job $0) (platform $0 mac) (title $0 Programmer) (loc $0 austin)))
show me jobs desiring a mscs in austin with microsoft ?	(lambda $0:e (and_ (job $0) (des_deg $0 MSCS) (loc $0 austin) (company $0 Microsoft)))
list all jobs using 'c++' and java in california ?	(lambda $0:e (and_ (job $0) (language $0 c++) (language $0 java) (loc $0 california)))
what jobs as manufacturing manager pay 100000 ?	(lambda $0:e (and_ (job $0) (title $0 "Manufacturing Manager") (salary_greater_than $0 100000 year)))
what jobs are there for 'c++' unix developer ?	(lambda $0:e (and_ (job $0) (language $0 c++) (platform $0 unix) (title $0 Developer)))
which jobs require c and 'c++' but not java ?	(lambda $0:e (and_ (job $0) (language $0 c) (language $0 c++) (not_ (language $0 java))))
what web jobs are available that need mac experience and no degree ?	(lambda $0:e (and_ (job $0) (area $0 web) (platform $0 mac) (not_ (req_deg $0)) (req_exp $0)))
is there anything for an old cobol programmer on mvs ?	(lambda $0:e (and_ (job $0) (language $0 cobol) (title $0 Programmer) (platform $0 mvs)))
which jobs are for bsee majors with at least 5 years experience in windows nt ?	(lambda $0:e (and_ (job $0) (req_deg $0 BSEE) (req_exp $0 5) (platform $0 "windows nt")))
which jobs are for bsee majors with at least 5 years experience in windows nt ?	(lambda $0:e (and_ (job $0) (req_deg $0 BSEE) (req_exp $0 5) (platform $0 "windows nt")))
what jobs are there which require java on windows and unix ?	(lambda $0:e (and_ (job $0) (language $0 java) (platform $0 windows) (platform $0 unix)))
show me austin jobs requiring a bscs degree with a salary greater than 50000 per year ?	(lambda $0:e (and_ (job $0) (loc $0 austin) (req_deg $0 BSCS) (salary_greater_than $0 50000 year)))
what ibm jobs require using java on commodores ?	(lambda $0:e (and_ (job $0) (company $0 IBM) (language $0 java) (platform $0 commodores)))
i sure would like a perl job at microsoft involving databases ?	(lambda $0:e (and_ (job $0) (language $0 perl) (company $0 Microsoft) (area $0 database)))
what ibm jobs require using java on commodores ?	(lambda $0:e (and_ (job $0) (company $0 IBM) (language $0 java) (platform $0 commodores)))
show me jobs in austin using solaris that do not require a bscs ?	(lambda $0:e (and_ (job $0) (loc $0 austin) (platform $0 solaris) (not_ (req_deg $0 BSCS))))
show me jobs in austin using solaris that do not require a bscs ?	(lambda $0:e (and_ (job $0) (loc $0 austin) (platform $0 solaris) (not_ (req_deg $0 BSCS))))
who might offer me 50000 for web development ?	(lambda $0:e (and_ (job $0) (salary_greater_than $0 50000 year) (area $0 web) (title $0 Developer)))
show me whats out there for perl developers on windows ?	(lambda $0:e (and_ (job $0) (language $0 perl) (title $0 Developer) (platform $0 windows)))
are there any jobs at dell that require no experience and pay 50000 ?	(lambda $0:e (and_ (job $0) (company $0 Dell) (not_ (req_exp $0)) (salary_greater_than $0 50000 year)))
what jobs use 'c++' on mac and pay 70000 ?	(lambda $0:e (and_ (job $0) (language $0 c++) (platform $0 mac) (salary_greater_than $0 70000 year)))
which jobs in houston offer over 50000 in graphics ?	(lambda $0:e (and_ (job $0) (loc $0 houston) (salary_greater_than $0 50000 year) (area $0 graphics)))
which jobs in houston offer over 50000 in graphics ?	(lambda $0:e (and_ (job $0) (loc $0 houston) (salary_greater_than $0 50000 year) (area $0 graphics)))
show me jobs in dallas requiring knowledge of linux and pays more than 50000 a year ?	(lambda $0:e (and_ (job $0) (loc $0 dallas) (platform $0 linux) (salary_greater_than $0 50000 year)))
show me the jobs concerning game developer on a playstation ?	(lambda $0:e (and_ (job $0) (area $0 games) (title $0 Developer) (platform $0 playstation)))
what jobs use cobol on ibm machines and pay 70000 ?	(lambda $0:e (and_ (job $0) (language $0 cobol) (platform $0 ibm) (salary_greater_than $0 70000 year)))
show me the networking jobs in houston with a salary of 50000 ?	(lambda $0:e (and_ (job $0) (area $0 networking) (loc $0 houston) (salary_greater_than $0 50000 year)))
what jobs are there for 'c++' programmers which pay more than 60000 per year ?	(lambda $0:e (and_ (job $0) (language $0 c++) (title $0 Programmer) (salary_greater_than $0 60000 year)))
what jobs are there working for microsoft programming lisp for autocad ?	(lambda $0:e (and_ (job $0) (company $0 Microsoft) (language $0 lisp) (application $0 autocad)))
show me houston jobs using c in the specialty area of oil pipeline modeling ?	(lambda $0:e (and_ (job $0) (loc $0 houston) (language $0 c) (area $0 "oil pipeline modeling")))
show me houston jobs using c in the specialty area of oil pipeline modeling ?	(lambda $0:e (and_ (job $0) (loc $0 houston) (language $0 c) (area $0 "oil pipeline modeling")))
what jobs are there working for microsoft programming lisp for autocad ?	(lambda $0:e (and_ (job $0) (company $0 Microsoft) (language $0 lisp) (application $0 autocad)))
what jobs in california require java and internet experience ?	(lambda $0:e (and_ (job $0) (loc $0 california) (language $0 java) (area $0 internet) (req_exp $0)))
show jobs that do not require a degree for visual basic programmers ?	(lambda $0:e (and_ (job $0) (not_ (req_deg $0)) (language $0 "visual basic") (title $0 Programmer)))
show me jobs in computer graphics requiring a ba in art and knowledge of 'speedy3dgraphics' ?	(lambda $0:e (and_ (job $0) (area $0 graphics) (req_deg $0 BA) (application $0 speedy3dgraphics)))
what jobs desire 2 years of experience with powerbuilder on windows nt ?	(lambda $0:e (and_ (job $0) (des_exp $0 2) (language $0 powerbuilder) (platform $0 "windows nt")))
show me jobs in computer graphics requiring a ba in art and knowledge of 'speedy3dgraphics' ?	(lambda $0:e (and_ (job $0) (area $0 graphics) (req_deg $0 BA) (application $0 speedy3dgraphics)))
what jobs desire 2 years of experience with powerbuilder on windows nt ?	(lambda $0:e (and_ (job $0) (des_exp $0 2) (language $0 powerbuilder) (platform $0 "windows nt")))
show the jobs offering 40000 working with c on windows nt ?	(lambda $0:e (and_ (job $0) (salary_greater_than $0 40000 year) (language $0 c) (platform $0 "windows nt")))
show the jobs offering 40000 working with c on windows nt ?	(lambda $0:e (and_ (job $0) (salary_greater_than $0 40000 year) (language $0 c) (platform $0 "windows nt")))
what jobs require experience in 'c++' and java but not perl ?	(lambda $0:e (and_ (job $0) (language $0 c++) (language $0 java) (not_ (language $0 perl)) (req_exp $0)))
what austin area web jobs require java and 'c++' ?	(lambda $0:e (and_ (job $0) (loc $0 austin) (area $0 web) (language $0 java) (language $0 c++)))
what jobs require 10 years of experience require a phd are in cobol and are located in texas ?	(lambda $0:e (and_ (job $0) (req_exp $0 10) (req_deg $0 PhD) (language $0 cobol) (loc $0 texas)))
what jobs require 10 years of experience require a phd in cs are in cobol and are located in texas ?	(lambda $0:e (and_ (job $0) (req_exp $0 10) (req_deg $0 PhD) (language $0 cobol) (loc $0 texas)))
show all intern positions in texas with network and java ?	(lambda $0:e (and_ (job $0) (title $0 intern) (loc $0 texas) (area $0 network) (language $0 java)))
moving to canada need a job with unix java and ibm ?	(lambda $0:e (and_ (job $0) (loc $0 canada) (platform $0 unix) (language $0 java) (platform $0 ibm)))
what developer jobs in austin require a bscs and 'c++' ?	(lambda $0:e (and_ (job $0) (title $0 Developer) (loc $0 austin) (req_deg $0 BSCS) (language $0 c++)))
show me jobs in tulsa using fortran on vax requiring a bscs ?	(lambda $0:e (and_ (job $0) (loc $0 tulsa) (language $0 fortran) (platform $0 vax) (req_deg $0 BSCS)))
are there any jobs in austin developing games in x86 using assembly ?	(lambda $0:e (and_ (job $0) (loc $0 austin) (area $0 games) (platform $0 x86) (language $0 assembly)))
show me jobs in tulsa using fortran on vax requiring a bscs ?	(lambda $0:e (and_ (job $0) (loc $0 tulsa) (language $0 fortran) (platform $0 vax) (req_deg $0 BSCS)))
what jobs are available that require java but not internet experience or ai experience ?	(lambda $0:e (and_ (job $0) (language $0 java) (not_ (or_ (and_ (area $0 internet) (req_exp $0)) (and_ (area $0 ai) (req_exp $0))))))
what jobs are there for austin mac programmer using 'c++' ?	(lambda $0:e (and_ (job $0) (loc $0 austin) (platform $0 mac) (title $0 Programmer) (language $0 c++)))
show me the jobs using perl with lockheed martin aeronautics in colorado ?	(lambda $0:e (and_ (job $0) (language $0 perl) (company $0 "Lockheed Martin Aeronautics") (loc $0 colorado)))
show me the jobs using perl with lockheed martin aeronautics in colorado ?	(lambda $0:e (and_ (job $0) (language $0 perl) (company $0 "Lockheed Martin Aeronautics") (loc $0 colorado)))
i wonder what jpl does on unix with prolog and vax ?	(lambda $0:e (and_ (job $0) (company $0 JPL) (platform $0 unix) (language $0 prolog) (platform $0 vax)))
what jobs in dallas require a bscs and 'c++' but not java ?	(lambda $0:e (and_ (job $0) (loc $0 dallas) (req_deg $0 BSCS) (language $0 c++) (not_ (language $0 java))))
mvs cobol and databases are the key to tivoli ?	(lambda $0:e (and_ (job $0) (platform $0 mvs) (language $0 cobol) (area $0 database) (company $0 Tivoli)))
what oracle jobs are there with compaq in houston using pc ?	(lambda $0:e (and_ (job $0) (application $0 oracle) (company $0 Compaq) (loc $0 houston) (platform $0 pc)))
which jobs offer me 40000 to work on internet and web with perl ?	(lambda $0:e (and_ (job $0) (salary_greater_than $0 40000 year) (area $0 internet) (area $0 web) (language $0 perl)))
what jobs as a senior software developer are available in houston but not san antonio ?	(lambda $0:e (and_ (job $0) (title $0 "Senior Software Developer") (loc $0 houston) (not_ (loc $0 "san antonio"))))
what jobs require a bscs 4 years of experience pay 50000 and are in san jose ?	(lambda $0:e (and_ (job $0) (req_deg $0 BSCS) (req_exp $0 4) (salary_greater_than $0 50000 year) (loc $0 "san jose")))
what jobs require a bscs 4 years of experience pay 50000 and are in san jose ?	(lambda $0:e (and_ (job $0) (req_deg $0 BSCS) (req_exp $0 4) (salary_greater_than $0 50000 year) (loc $0 "san jose")))
what jobs using java and perl are available in dallas and pay 50000 a year ?	(lambda $0:e (and_ (job $0) (language $0 java) (language $0 perl) (loc $0 dallas) (salary_greater_than $0 50000 year)))
show me management jobs in boston requiring an mba and the knowledge of visual basic ?	(lambda $0:e (and_ (job $0) (area $0 management) (loc $0 boston) (req_deg $0 MBA) (language $0 "visual basic")))
show me management jobs in boston requiring an mba and the knowledge of visual basic ?	(lambda $0:e (and_ (job $0) (area $0 management) (loc $0 boston) (req_deg $0 MBA) (language $0 "visual basic")))
what jobs in california pay 60000 for sql development ?	(lambda $0:e (and_ (job $0) (loc $0 california) (salary_greater_than $0 60000 year) (language $0 sql) (title $0 Developer)))
what jobs in san jose offer a java programmer for 40000 a year ?	(lambda $0:e (and_ (job $0) (loc $0 "san jose") (language $0 java) (title $0 Programmer) (salary_greater_than $0 40000 year)))
what engineer positions in telecommunications companies in dallas do not require 'c++' ?	(lambda $0:e (and_ (job $0) (title $0 engineer) (area $0 telecommunications) (loc $0 dallas) (not_ (language $0 c++))))
are there jobs using vb in seattle with sql server and on windows nt ?	(lambda $0:e (and_ (job $0) (language $0 vb) (loc $0 seattle) (application $0 "sql server") (platform $0 "windows nt")))
which system administrator jobs in dallas require 2 years experience and pay 50000 ?	(lambda $0:e (and_ (job $0) (title $0 "System Administrator") (loc $0 dallas) (req_exp $0 2) (salary_greater_than $0 50000 year)))
which system administrator jobs in dallas require 2 years experience and pay 50000 ?	(lambda $0:e (and_ (job $0) (title $0 "System Administrator") (loc $0 dallas) (req_exp $0 2) (salary_greater_than $0 50000 year)))
is ibm hiring c programmers who know unix in austin	(lambda $0:e (and_ (job $0) (company $0 IBM) (language $0 c) (title $0 Programmer) (platform $0 unix) (loc $0 austin)))
test engineer in need of 40000 in seattle on windows nt ?	(lambda $0:e (and_ (job $0) (title $0 "Test Engineer") (salary_greater_than $0 40000 year) (loc $0 seattle) (platform $0 "windows nt")))
what jobs in austin are for a lisp programmer that involve unix and the internet ?	(lambda $0:e (and_ (job $0) (loc $0 austin) (language $0 lisp) (title $0 Programmer) (platform $0 unix) (area $0 internet)))
what jobs give me 40000 to work in houston on internet and web with perl ?	(lambda $0:e (and_ (job $0) (salary_greater_than $0 40000 year) (loc $0 houston) (area $0 internet) (area $0 web) (language $0 perl)))
what jobs are there in austin for project manager area games on mac using pascal ?	(lambda $0:e (and_ (job $0) (loc $0 austin) (title $0 "Project Manager") (area $0 games) (platform $0 mac) (language $0 pascal)))
whats in dallas that pays over 60000 on linux with graphics and java ?	(lambda $0:e (and_ (job $0) (loc $0 dallas) (salary_greater_than $0 60000 year) (platform $0 linux) (area $0 graphics) (language $0 java)))
show me jobs in austin that use java on unix for a developer paying at least 50000 ?	(lambda $0:e (and_ (job $0) (loc $0 austin) (language $0 java) (platform $0 unix) (title $0 Developer) (salary_greater_than $0 50000 year)))
vanity wants 5000 a month with buzwords like java apple internet and california ?	(lambda $0:e (and_ (job $0) (salary_greater_than $0 5000 month) (language $0 java) (company $0 Apple) (area $0 internet) (loc $0 california)))
if i moved to california and learned sql on oracle could i find anything for 30000 on unix ?	(lambda $0:e (and_ (job $0) (loc $0 california) (language $0 sql) (application $0 oracle) (salary_greater_than $0 30000 year) (platform $0 unix)))
greed for 80000 and java plagues developer wanting to live in san jose at apple ?	(lambda $0:e (and_ (job $0) (salary_greater_than $0 80000 year) (language $0 java) (title $0 "Software Developer") (loc $0 "san jose") (company $0 Apple)))
only microsoft vb windows nt and excel and 70000 dollars can satiate me ?	(lambda $0:e (and_ (job $0) (company $0 Microsoft) (language $0 vb) (platform $0 "windows nt") (application $0 excel) (salary_greater_than $0 70000 year)))
